鸡	jī: fowl; chicken; CL:隻|只[zhi1];	
雞	jī: fowl; chicken; CL:隻|只[zhi1];	
湯	tāng: soup; hot or boiling water; decoction of medicinal herbs; water in which sth has been boiled;	
炒	chǎo: to sauté; to stir-fry; to speculate; to hype; to fire (sb);	
豆腐	dòu fu: tofu; bean curd;	
牛肉	níu ròu: beef;	
麵	miàn: flour; noodles;	
虾	xiā: shrimp; prawn;	
蝦	xiā: shrimp; prawn;	
菜	cài: dish (type of food); vegetable; cuisine; CL:盤|盘[pan2],道[dao4]; (coll.) (one&#x27;s) type;	
椒	jiāo: pepper;	
肉絲	ròu sī: shredded meat; shredded pork;	
煲	bāo: pot or saucepan; to boil; cook or heat;	
牛	Níu: surname Niu;  níu: ox; cow; bull; CL:條|条[tiao2],頭|头[tou2]; (slang) awesome;	
肉丝	ròu sī: shredded meat; shredded pork;	
肉	ròu: meat; flesh; pulp (of a fruit); (coll.) (of a fruit) squashy; (of a person) flabby; irresolute;	
炒飯/炒饭	chǎo fàn: fried rice; (Taiwan slang) to have sex;	
魚	Yú: surname Yu;  yú: fish; CL:條|条[tiao2],尾[wei3];	
汁	zhī: juice;	
飯/饭	fàn: food; cuisine; cooked rice; meal; CL:碗[wan3],頓|顿[dun4];	
排骨	pái gǔ: pork chop; pork cutlet; spare ribs;	
海鮮/海鲜	hǎi xiān: seafood;	
或	huò: maybe; perhaps; might; possibly; or;	
香	xiāng: fragrant; sweet smelling; aromatic; savory or appetizing; (to eat) with relish; (of sleep) sound; perfume or spice; joss or incense stick; CL:根[gen1];	
球	qíu: ball; sphere; globe; CL:個|个[ge4]; ball game; match; CL:場|场[chang3];	
炒麵	chǎo miàn: stir-fried noodles; &quot;chow mein&quot;;	
羊肉	yáng ròu: mutton; goat meat;	
鹽	yán: salt; CL:粒[li4];	
盐	yán: salt; CL:粒[li4];	
蛋	dàn: egg; oval-shaped; CL:個|个[ge4],打[da2];	
乾	gān: dry	
锅	guō: pot; pan; boiler; CL:口[kou3],隻|只[zhi1];	
鍋	guō: pot; pan; boiler; CL:口[kou3],隻|只[zhi1];	
丝	sī: silk; thread; trace; CL:條|条[tiao2];	
絲	sī: silk; thread; trace; CL:條|条[tiao2];	
魚香/鱼香	yú xiāng: yuxiang, a seasoning of Chinese cuisine that typically contains garlic, scallions, ginger, sugar, salt, chili peppers etc, but no seafood, although yuxiang literally means &quot;fish fragrance&quot;;	
粉	fěn: powder; cosmetic face powder; food prepared from starch; noodles or pasta made from any kind of flour; whitewash; white; pink;	
类	lèi: kind; type; class; category; similar; like; to resemble;	
老	lǎo: prefix used before the surname of a person or a numeral indicating the order of birth of the children in a family or to indicate affection or familiarity; old (of people); venerable (person); experienced; of long standing; always; all the time; of the past; very; outdated; (of meat etc) tough;	
類	lèi: kind; type; class; category; similar; like; to resemble;	
辣	là: old variant of 辣[la4];  là: hot (spicy); pungent;	
醬/酱	jiàng: thick paste of fermented soybean; marinated in soy paste; paste; jam;	
魚片/鱼片	yú piàn: fish fillet; slice of fish meat;	
蔥	cōng: scallion; green onion;	
茄子	qié zi: eggplant (Solanum melongena L.); aubergine; brinjal; Guinea squash; phonetic &quot;cheese&quot; (when being photographed); equivalent of &quot;say cheese&quot;;	
片	piān: disk; sheet;  piàn: thin piece; flake; a slice; film; TV play; to slice; to carve thin; partial; incomplete; one-sided; classifier for slices, tablets, tract of land, area of water; classifier for CDs, movies, DVDs etc; used with numeral 一[yi1]: classifier for scenario, scene, feeling, atmosphere, sound etc;	
鴨/鸭	yā: duck; CL:隻|只[zhi1];	
烤	kǎo: to roast; to bake; to broil;	
豬肉	zhū ròu: pork;	
北京	Běi jīng: Beijing, capital of People&#x27;s Republic of China; Peking; PRC government;	
砂鍋	shā guō: casserole; earthenware pot;	
砂锅	shā guō: casserole; earthenware pot;	
红烧	hóng shāo: simmer-fried (dish);	
宮	gōng: palace; temple;	
花	huā: flower; blossom; CL:朵[duo3],支[zhi1],束[shu4],把[ba3],盆[pen2],簇[cu4]; fancy pattern; florid; to spend (money, time);	
紅燒	hóng shāo: simmer-fried (dish);	
叉燒/叉烧	chā shāo: char siu; barbecued pork;	
豬/猪	zhū: hog; pig; swine; CL:口[kou3],頭|头[tou2];	
餅/饼	bǐng: round flat cake; cookie; cake; pastry; CL:張|张[zhang1];	
素	sù: raw silk; white; plain, unadorned; vegetarian (food); essence; nature; element; constituent; usually; always; ever;	
蒸	zhēng: to evaporate; (of cooking) to steam; torch made from hemp stalks or bamboo (old); finely chopped firewood (old);	
大	dà: big; huge; large; major; great; wide; deep; older (than); oldest; eldest; greatly; very much; (dialect) father; father&#x27;s elder or younger brother;  dài: see 大夫[dai4 fu5];	
保	Bǎo: Bulgaria; Bulgarian; abbr. for 保加利亞|保加利亚[Bao3 jia1 li4 ya4];  bǎo: to defend; to protect; to keep; to guarantee; to ensure;	
四季豆	sì jì dòu: green bean; French bean; runner bean;	
小	xiǎo: small; tiny; few; young;	
炸	zhá: to deep fry;  zhà: to explode;	
青椒	qīng jiāo: Capsicum annuum; green pepper;	
三鮮	sān xiān: three fresh ingredients (in cooking);	
皮	pí: leather; skin; fur; CL:張|张[zhang1]; pico- (one trillionth); naughty;	
西	Xī: the West; abbr. for Spain 西班牙[Xi1 ban1 ya2]; Spanish;  xī: west;	
爆	bào: to explode or burst; to quick fry or quick boil;	
套餐	tào cān: set meal; product or service package (e.g. for a cell phone subscription);	
四川	Sì chuān: Sichuan province (Szechuan) in southwest China, abbr. 川 or 蜀, capital Chengdu 成都;	
上海	Shàng hǎi: Shanghai municipality, central east China, abbr. to 滬|沪[Hu4];	
三	Sān: surname San;  sān: three; 3;	
烧	shāo: to burn; to cook; to stew; to bake; to roast; to boil (tea, water etc); fever;	
芥蘭	gài lán: variant of 芥藍|芥蓝[gai4 lan2];	
水	shuǐ: water; river; liquid; beverage; additional charges or income; (of clothes) classifier for number of washes;	
鸡蛋	jī dàn: (chicken) egg; hen&#x27;s egg; CL:個|个[ge4],打[da2];	
燒	shāo: to burn; to cook; to stew; to bake; to roast; to boil (tea, water etc); fever;	
雞蛋	jī dàn: (chicken) egg; hen&#x27;s egg; CL:個|个[ge4],打[da2];	
紅	Hóng: surname Hong;  hóng: red; popular; revolutionary; bonus;	
麻辣	má là: hot and numbing;	
鮮/鲜	xiān: fresh; bright (in color); delicious; tasty; delicacy; aquatic foods;  xiǎn: few; rare;	
河	hé: river; CL:條|条[tiao2],道[dao4]; wide rice noodle (河粉)	
红	hóng: red	
酸菜	suān cài: pickled vegetables, especially Chinese cabbage;	
煮	zhǔ: variant of 煮[zhu3];  zhǔ: to cook; to boil;	
油	yóu: oil; fat; grease; petroleum; to apply tung oil, paint or varnish; oily; greasy; glib; cunning;	
煎	jiān: to pan fry; to sauté;	
鸡肉	jī ròu: chicken meat;	
幹	gàn: tree trunk; main part of sth; to manage; to work; to do; capable; cadre; to fuck; sometimes used as an alternative form of 乾／干	
白菜	bái cài: Chinese cabbage; pak choi; CL:棵[ke1], 個|个[ge4];	
雞肉	jī ròu: chicken meat;	
水饺	shuǐ jiǎo: boiled dumpling;	
涼拌/凉拌	liáng bàn: salad with dressing; cold vegetables dressed with sauce (e.g. coleslaw);	
水餃	shuǐ jiǎo: boiled dumpling;	
蓋飯/盖饭	gài fàn: rice with meat and vegetables;	
味	wèi: taste; smell; classifier for drugs (in TCM);	
羊	Yáng: surname Yang;  yáng: sheep; goat; CL:頭|头[tou2],隻|只[zhi1];	
上	shàng: on top; upon; above; upper; previous; first (of multiple parts); to climb; to get onto; to go up; to attend (class or university);	
鸡丁	jī dīng: diced chicken meat;	
酸	suān: sour; tart; sick at heart; grieved; sore; aching; pedantic; impractical; an acid;	
韭菜	jǐu cài: garlic chives; Chinese chives; Chinese leek;	
雞丁	jī dīng: diced chicken meat;	
香菇	xiāng gū: shiitake (Lentinus edodes), an edible mushroom;	
芝麻	zhī ma: sesame (seed);	
包	Bāo: surname Bao;  bāo: to cover; to wrap; to hold; to include; to take charge of; to contract (to or for); package; wrapper; container; bag; to hold or embrace; bundle; packet; CL:個|个[ge4],隻|只[zhi1];	
奶茶	nǎi chá: milk tea;	
綠茶	lǜ chá: green tea;	
咖哩	kā li: curry (loanword);	
绿茶	lǜ chá: green tea;	
粒	lì: grain; granule; classifier for small round things (peas, bullets, peanuts, pills, grains etc);	
牛腩	níu nǎn: brisket (esp. Cantonese); belly beef; spongy meat from cow&#x27;s underside and neighboring ribs; erroneously translated as sirloin;	
卷	juǎn: to roll up; roll; classifier for small rolled things (wad of paper money, movie reel etc);  juàn: scroll; book; volume; chapter; examination paper; classifier for books, paintings: volume, scroll;  juǎn: to roll (up); to sweep up; to carry on; roll;	
骨	gǔ: bone;	
黑	hēi: black; dark;	
蜜	mì: honey;	
涼	liáng: cool; cold;  liàng: to let sth cool down;	
菌	jūn: germ; bacteria; fungus; mold; Taiwan pr. [jun4];  jùn: mushroom;	
翅	chì: wing;	
铁板	tiě bǎn: iron panel; hot iron plate for fast grilling (Japanese: teppan);	
豆	dòu: bean; pea; CL:棵[ke1],粒[li4]; sacrificial vessel;	
鐵板	tiě bǎn: iron panel; hot iron plate for fast grilling (Japanese: teppan);	
凉	liáng: cool; cold;  liàng: to let sth cool down;	
手	shǒu: hand; (formal) to hold; person engaged in certain types of work; person skilled in certain types of work; personal(ly); convenient; classifier for skill; CL:雙|双[shuang1],隻|只[zhi1];	
羹	gēng: soup;	
什菜	shí cài: mixed vegetables;	
捞	lāo: to fish up; to dredge up;	
蒜	suàn: garlic; CL:頭|头[tou2],瓣[ban4];	
雪	Xuě: surname Xue;  xuě: snow; snowfall; CL:場|场[chang2]; to have the appearance of snow; to wipe away, off or out; to clean;	
撈	lāo: to fish up; to dredge up;	
虾仁	xiā rén: shrimp meat; shelled shrimp;	
子	zǐ: son; child; seed; egg; small thing; 1st earthly branch: 11 p.m.-1 a.m., midnight, 11th solar month (7th December to 5th January), year of the Rat; Viscount, fourth of five orders of nobility 五等爵位[wu3 deng3 jue2 wei4];  zi: (noun suffix);	
燜/焖	mèn: to cook in a covered vessel; to casserole; to stew;	
面	miàn: face; side; surface; aspect; top; classifier for flat surfaces such as drums, mirrors, flags etc;  miàn: variant of 麵|面[mian4];  miàn: flour; noodles;	
番茄	fān qié: tomato;	
什錦/什锦	shí jǐn: (food) assorted; mixed; assortment;	
蒜蓉	suàn róng: minced garlic; garlic paste;	
蝦仁	xiā rén: shrimp meat; shelled shrimp;	
豉	chǐ: salted fermented beans;	
焗	jú: (dialect) to cook in salt or sand, inside a sealed pot; to steam; to bake;	
菇	gū: mushroom;	
回鍋肉	huí guō ròu: twice cooked pork;	
瓜	guā: melon; gourd; squash;	
粉絲	fěn sī: bean vermicelli; mung bean starch noodles; Chinese vermicelli; cellophane noodles; CL:把[ba3]; fan (loanword); enthusiast for sb or sth;	
肚	dǔ: tripe;  dù: belly;	
奶	nǎi: breast; milk; to breastfeed;  nǎi: variant of 嬭|奶[nai3];  nǎi: mother; variant of 奶[nai3];	
仔	zǎi: variant of 崽[zai3];  zī: see 仔肩[zi1 jian1];  zǐ: meticulous; (of domestic animals or fowls) young;	
百	Bǎi: surname Bai;  bǎi: hundred; numerous; all kinds of;	
茶	chá: tea; tea plant; CL:杯[bei1],壺|壶[hu2];	
粉丝	fěn sī: bean vermicelli; mung bean starch noodles; Chinese vermicelli; cellophane noodles; CL:把[ba3]; fan (loanword); enthusiast for sb or sth;	
脆	cuì: old variant of 脆[cui4];  cuì: brittle; fragile; crisp; crunchy; clear and loud voice; neat;	
排	pái: a row; a line; to set in order; to arrange; to line up; to eliminate; to drain; to push open; platoon; raft; classifier for lines, rows etc;	
回锅肉	huí guō ròu: twice cooked pork;	
炒蛋	chǎo dàn: scrambled eggs;	
甜酸	tián suān: sweet and sour;	
土豆絲	tǔ dòu sī: shredded potato;	
鼓	gǔ: old variant of 鼓[gu3];  gǔ: drum; CL:通[tong4],面[mian4]; to drum; to strike; to rouse; to bulge; to swell;	
腩	nǎn: brisket; belly beef; spongy meat from cow&#x27;s underside and neighboring ribs; see 牛腩[niu2 nan3] esp. Cantonese; erroneously translated as sirloin;	
土豆丝	tǔ dòu sī: shredded potato;	
河粉	hé fěn: rice noodles in wide strips;	
麻	má: variant of 麻[ma2]; hemp;  Má: surname Ma;  má: generic name for hemp, flax etc; hemp or flax fiber for textile materials; sesame; CL:縷|缕[lu:3]; (of materials) rough or coarse; pocked; pitted; to have pins and needles or tingling; to feel numb;	
米飯	mǐ fàn: (cooked) rice;	
蘿蔔	luó bo: radish (Raphanus sativus), esp. white radish 白蘿蔔|白萝卜[bai2 luo2 bo5]; CL:條|条[tiao2];	
萝卜	luó bo: radish (Raphanus sativus), esp. white radish 白蘿蔔|白萝卜[bai2 luo2 bo5]; CL:條|条[tiao2];	
米饭	mǐ fàn: (cooked) rice;	
玉米	yù mǐ: corn; maize; CL:粒[li4];	
木耳	mù ěr: edible tree fungus; CL:朵[duo3];	
土豆	tǔ dòu: potato; CL:個|个[ge4]; (Tw) peanut; CL:顆|颗[ke1];	
頭	tóu: head; hair style; the top; end; beginning or end; a stub; remnant; chief; boss; side; aspect; first; leading; classifier for pigs or livestock; CL:個|个[ge4];  tou: suffix for nouns;	
蘑菇	mó gu: mushroom; to pester; to dawdle;	
黄	Huáng: surname Huang or Hwang;  huáng: yellow; pornographic; to fall through;	
一	yī: one; 1; single; a (article); as soon as; entire; whole; all; throughout; &quot;one&quot; radical in Chinese characters (Kangxi radical 1); also pr. [yao1] for greater clarity when spelling out numbers digit by digit;	
生	shēng: to be born; to give birth; life; to grow; raw; uncooked; student;	
芹菜	qín cài: celery (Apium graveolens);	
肉片	ròu piàn: meat slice;	
黃	huáng: yellow	
黃瓜	huáng guā: cucumber; CL:條|条[tiao2];	
粥	yù: see 葷粥|荤粥[Xun1 yu4];  zhōu: congee; gruel; porridge; CL:碗[wan3];	
米粉	mǐ fěn: rice flour; rice-flour noodles;	
梅	méi: plum; plum flower; Japanese apricot (Prunus mume);  méi: variant of 梅[mei2];	
火	huǒ: fire; urgent; ammunition; fiery or flaming; internal heat (Chinese medicine); hot (popular); classifier for military units (old);	
苗	miáo: sprout;	
双	shuāng: two; double; pair; both; even (number);	
酒	jǐu: wine (esp. rice wine); liquor; spirits; alcoholic beverage; CL:杯[bei1],瓶[ping2],罐[guan4],桶[tong3],缸[gang1];	
白	Bái: surname Bai;  bái: white; snowy; pure; bright; empty; blank; plain; clear; to make clear; in vain; gratuitous; free of charge; reactionary; anti-communist; funeral; to stare coldly; to write wrong character; to state; to explain; vernacular; spoken lines in opera;	
雙	Shuāng: surname Shuang;  shuāng: two; double; pair; both; even (number);	
炒米	chǎo mǐ: fried rice; millet stir-fried in butter;	
辣子	là zi: cayenne pepper; chili;	
尖椒	jiān jiāo: chili pepper;	
皇	Huáng: emperor; surname Huang;	
肥腸/肥肠	féi cháng: pig-gut (large intestine used as foodstuff);	
条	tiáo: strip; item; article; clause (of law or treaty); classifier for long thin things (ribbon, river, road, trousers etc);	
叶	Yè: surname Ye;  yè: leaf; page; lobe; (historical) period; classifier for small boats;	
蜆/蚬	xiǎn: Cyclina orientalis; basket clam	
魷魚	yóu yú: squid;	
干	gān: simplified form of 乾[gan1];    gān: dry; clean; in vain; dried food; foster; adoptive; to ignore;	
串	chuàn: to string together; to mix up; to conspire; to rove; to make a swift or abrupt linear movement (like a bead on an abacus); to move across; bunch or cluster; string (computing); classifier for rows or strings;	
海帶	hǎi dài: kelp;	
條	tiáo: strip; item; article; clause (of law or treaty); classifier for long thin things (ribbon, river, road, trousers etc);	
蔬菜	shū cài: vegetables; produce; CL:種|种[zhong3];	
筋	jīn: muscle; tendon;	
式	shì: type; form; pattern; style;	
火腿	huǒ tuǐ: ham; CL:個|个[ge4];	
婆	pó: grandmother; matron; mother-in-law;	
葉	Yè: surname Ye;  yè: leaf; page; lobe; (historical) period; classifier for small boats;	
滷	lǔ: to stew in soy sauce and spices;	
蒙古	Měng gǔ: Mongolia;	
班	Bān: surname Ban;  bān: team; class; squad; work shift; ranking; CL:個|个[ge4]; classifier for groups;	
鱿鱼	yóu yú: squid;	
海带	hǎi dài: kelp;	
綠	lǜ: green;	
須	xū: must; to have to; to wait;	
燴飯	huì fàn: rice in gravy, typically with meat and vegetables;	
本	běn: roots or stems of plants; origin; source; this; the current; root; foundation; basis; classifier for books, periodicals, files etc; originally;	
大蝦	dà xiā: prawn; (Internet slang) expert; whiz;	
酥	sū: flaky pastry; crunchy; limp; soft; silky;	
隻	zhī: classifier for birds and certain animals, one of a pair, some utensils, vessels etc;	
什	shén: what;  shí: assorted; ten (used in fractions, writing checks etc); miscellaneous;	
鹹魚	xián yú: salted fish;	
碎	suì: to break down; to break into pieces; fragmentary;	
烩饭	huì fàn: rice in gravy, typically with meat and vegetables;	
大虾	dà xiā: prawn; (Internet slang) expert; whiz;	
咸鱼	xián yú: salted fish;	
馒头	mán tou: steamed roll; steamed bun; steamed bread; CL:個|个[ge4];	
绿	lǜ: green;	
木須	mù xū: moo shu; stir-fried egg, vegetables, and meat	
柿	shì: persimmon;	
饅頭	mán tou: steamed roll; steamed bun; steamed bread; CL:個|个[ge4];	
年糕	nián gāo: nian gao, New Year cake made of steamed glutinous rice; Japanese mochi;	
腰果	yāo guǒ: cashew nuts;	
金针菇	jīn zhēn gū: enoki mushroom (Flammulina velutipes, Japanese えのき茸 enokitake), used in cuisines of Japan, Korea and China, cultivated to be long, thin and white; abbr. to 金菇;	
锅贴	guō tiē: fried dumpling; potsticker;	
芥蓝	gài lán: Chinese broccoli; Chinese kale; cabbage mustard; Brassica oleracea var. alboglabra; also pr. [jie4 lan2];	
个	gè: individual; this; that; size; classifier for people or objects in general;  gè: variant of 個|个[ge4];	
陈皮	chén pí: orange peel; tangerine peel; dried orange peel used in Chinese medicine;	
龙利	lóng lì: sole; right-eyed flounder; flatfish; see also 鰈|鲽[die2];	
云吞	yún tūn: wonton;	
個	gè: individual; this; that; size; classifier for people or objects in general;	
陳皮	chén pí: orange peel; tangerine peel; dried orange peel used in Chinese medicine;	
龍利	lóng lì: sole; right-eyed flounder; flatfish; see also 鰈|鲽[die2];	
牌	pái: (name) brand; mahjong tile; playing card; game pieces; signboard; plate; tablet; medal; CL:片[pian4],個|个[ge4],塊|块[kuai4];	
咖啡	kā fēi: coffee (loanword); CL:杯[bei1];	
木	Mù: mù: tree; wood; coffin; wooden; simple; numb; one of the eight ancient musical instruments 八音[ba1 yin1];	
素菜	sù cài: vegetable dish;	
雲吞	yún tūn: wonton;	
芥藍	gài lán: Chinese broccoli; Chinese kale; cabbage mustard; Brassica oleracea var. alboglabra; also pr. [jie4 lan2];	
鍋貼	guō tiē: fried dumpling; potsticker;	
花菜	huā cài: cauliflower;	
扁	biǎn: flat; (coll.) to beat (sb) up; old variant of 匾[bian3];  piān: small boat;	
金針菇	jīn zhēn gū: enoki mushroom (Flammulina velutipes, Japanese えのき茸 enokitake), used in cuisines of Japan, Korea and China, cultivated to be long, thin and white; abbr. to 金菇;	
溜	līu: to slip away; to escape in stealth; to skate;	
九	jǐu: nine; 9;	
擔	dān: to undertake; to carry; to shoulder; to take responsibility;  dàn: picul (100 catties, 50 kg); two buckets full; carrying pole and its load; classifier for loads carried on a shoulder pole;	
蟹肉	xiè ròu: crab meat;	
四	sì: four; 4;	
撕	sī: to tear;	
春卷	chūn juǎn: egg roll; spring roll;	
左	zuǒ: left; the Left (politics); east; unorthodox; queer; wrong; differing; opposite; variant of 佐[zuo3];	
宗	zōng: school; sect; purpose; model; ancestor; clan; to take as one&#x27;s model (in academic or artistic work); classifier for batches, items, cases (medical or legal), reservoirs;	
鹹	xián: salted; salty; stingy; miserly;	
滑	huá: to slip; to slide; smooth; slippery; cunning;	
配	pèi: to join; to fit; to mate; to mix; to match; to deserve; to make up (a prescription); to allocate;	
担	dān: to undertake; to carry; to shoulder; to take responsibility;  dàn: picul (100 catties, 50 kg); two buckets full; carrying pole and its load; classifier for loads carried on a shoulder pole;	
楼	lóu: house with more than 1 story; storied building; floor; CL:層|层[ceng2],座[zuo4],棟|栋[dong4];	
大肠	dà cháng: the large intestine;	
笋	sǔn: bamboo shoot;	
扒	bā: to hold on to; to cling to; to dig up; to rake; to push aside; to climb; to pull out; to strip off;  pá: to rake up; to steal; to braise; to crawl;	
豆角	dòu jiǎo: string bean; snap bean; green bean;	
糖醋	táng cù: sweet and sour;	
冰	bīng: ice; CL:塊|块[kuai4]; methamphetamine (slang);  bīng: variant of 冰[bing1];	
啤酒	pí jǐu: beer (loanword); CL:杯[bei1],瓶[ping2],罐[guan4],桶[tong3],缸[gang1];	
核桃	hé tao: walnut; CL:個|个[ge4],棵[ke1];	
筍	sǔn: bamboo shoot;	
大腸	dà cháng: the large intestine;	
樓	lóu: house with more than 1 story; storied building; floor; CL:層|层[ceng2],座[zuo4],棟|栋[dong4];	
蚝油	háo yóu: oyster sauce;	
兰	lán: orchid (蘭花|兰花 Cymbidium goeringii); fragrant thoroughwort (蘭草|兰草 Eupatorium fortunei); lily magnolia (木蘭|木兰);	
龙虾	lóng xiā: lobster;	
腊	xī: dried meat; also pr. [xi2];  là: old variant of 臘|腊[la4]; 12th lunar month;  là: 12th lunar month; preserved (meat, fish etc);	
猪扒	zhū pá: see 豬排|猪排[zhu1 pai2];	
红豆	hóng dòu: azuki bean; red bean;	
牛肉面	níu ròu miàn: beef noodle soup;	
肠	cháng: intestines;  cháng: old variant of 腸|肠[chang2];	
利	lì: sharp; favorable; advantage; benefit; profit; interest; to do good to; to benefit;	
精美	jīng měi: delicate; fine; refinement;	
米	mǐ: rice; CL:粒[li4]; meter (classifier);	
紅豆	hóng dòu: azuki bean; red bean;	
榨菜	zhà cài: hot pickled mustard tuber;	
豬扒	zhū pá: see 豬排|猪排[zhu1 pai2];	
咖喱	gā lí: curry (loanword);	
牛柳	níu lǐu: sirloin;	
孜然	zī rán: cumin (Cuminum cyminum);	
青	Qīng: abbr. for 青海[Qing1 hai3], Qinghai Province;  qīng: nature&#x27;s color; green or blue; greenish black; youth; young (of people);	
柱	zhù: pillar; CL:根[gen1];	
肘	zhǒu: elbow; pork shoulder;	
扣肉	kòu ròu: steamed pork;	
臘	là: 12th lunar month; preserved (meat, fish etc);	
龍蝦	lóng xiā: lobster;	
毛豆	máo dòu: green soy bean;	
冬菇	dōng gū: grade of Shiitake mushroom (Lentinula edodes);	
珍	zhēn: precious thing; treasure; culinary delicacy; rare; valuable; to value highly;  zhēn: variant of 珍[zhen1];	
南瓜	nán guā: pumpkin;	
蘭	lán: orchid (蘭花|兰花 Cymbidium goeringii); fragrant thoroughwort (蘭草|兰草 Eupatorium fortunei); lily magnolia (木蘭|木兰);	
清蒸	qīng zhēng: steamed in broth;	
心	xīn: heart; mind; intention; center; core; CL:顆|颗[ke1],個|个[ge4];	
蠔油	háo yóu: oyster sauce;	
羅漢	luó hàn: abbr. for 阿羅漢|阿罗汉[a1 luo2 han4];	
腸	cháng: intestines;	
藕	ǒu: root of lotus;	
金	Jīn: surname Jin; surname Kim (Korean); Jurchen Jin dynasty (1115-1234);  jīn: gold; chemical element Au; generic term for lustrous and ductile metals; money; golden; highly respected; one of the eight ancient musical instruments 八音[ba1 yin1];	
糕	gāo: cake;  gāo: variant of 糕[gao1];	
牛肉麵	níu ròu miàn: beef noodle soup;	
杯	bēi: trophy cup; cup; classifier for certain containers of liquids: glass, cup;  bēi: variant of 杯[bei1];  bēi: variant of 杯[bei1]; trophy cup; classifier for certain containers of liquids: glass, cup;	
罗汉	luó hàn: abbr. for 阿羅漢|阿罗汉[a1 luo2 han4];	
系列	xì liè: series;	
花生	huā shēng: peanut; groundnut; CL:粒[li4];	
蘋果	píng guǒ: apple; CL:個|个[ge4],顆|颗[ke1];	
湯類	tāng lèi: soup dishes (on menu);	
泡椒	pào jiāo: pickled pepper;	
揚州	Yáng zhōu: Yangzhou prefecture level city in Jiangsu;	
川	Chuān: abbr. for Sichuan Province 四川[Si4 chuan1] in southwest China;  chuān: river; creek; plain; an area of level country;	
小菜	xiǎo cài: appetizer; small side dish; easy job; piece of cake; see also 小菜一碟[xiao3 cai4 yi1 die2];	
拌	bàn: to mix; to mix in; to toss (a salad);	
瑤	Yáo: Yao ethnic group of southwest China and southeast Asia; surname Yao;  yáo: jade; precious stone; mother-of-pearl; nacre; precious; used a complementary honorific;	
油餅	yóu bǐng: deep-fried doughcake; oilcake (animal fodder);	
醋	cù: vinegar; jealousy (in love rivalry);	
白肉	bái ròu: plain boiled pork;	
京	Jīng: abbr. for Beijing; surname Jing; Jing ethnic minority;  jīng: capital city of a country; big; algebraic term for a large number (old); artificial mound (old);	
包子	bāo zi: steamed stuffed bun; CL:個|个[ge4];	
午餐	wǔ cān: lunch; luncheon; CL:份[fen4],頓|顿[dun4],次[ci4];	
肉餅	ròu bǐng: meat patty;	
泥	ní: mud; clay; paste; pulp;  nì: restrained;	
蠔	háo: oyster;	
牛仔	níu zǎi: cowboy;	
雞扒	jī pá: see 雞排|鸡排[ji1 pai2];	
濃湯	nóng tāng: thick soup; puree;	
帶子	dài zi: belt; band; ribbon; strap; girdle; (coll.) audio or video tape;	
大豆	dà dòu: soybean;	
樣	yàng: manner; pattern; way; appearance; shape; classifier: kind, type;	
瑶	Yáo: Yao ethnic group of southwest China and southeast Asia; surname Yao;  yáo: jade; precious stone; mother-of-pearl; nacre; precious; used a complementary honorific;	
扬州	Yáng zhōu: Yangzhou prefecture level city in Jiangsu;	
汤类	tāng lèi: soup dishes (on menu);	
苹果	píng guǒ: apple; CL:個|个[ge4],顆|颗[ke1];	
柠檬	níng méng: lemon;	
热	rè: to warm up; to heat up; hot (of weather); heat; fervent;	
鸡扒	jī pá: see 雞排|鸡排[ji1 pai2];	
浓汤	nóng tāng: thick soup; puree;	
带子	dài zi: belt; band; ribbon; strap; girdle; (coll.) audio or video tape;	
样	yàng: manner; pattern; way; appearance; shape; classifier: kind, type;	
蚝	háo: oyster;	
肉饼	ròu bǐng: meat patty;	
全	Quán: surname Quan;  quán: all; whole; entire; every; complete;	
青菜	qīng cài: green vegetables; Chinese cabbage;	
清炒	qīng chǎo: to stir-fry; to saute;	
香乾	xiāng gān: smoked bean curd;	
特色	tè sè: characteristic; distinguishing feature or quality;	
熱	rè: to warm up; to heat up; hot (of weather); heat; fervent;	
檸檬	níng méng: lemon;	
咸	Xián: surname Xian;  xián: all; everyone; each; widespread; harmonious;  xián: salted; salty; stingy; miserly;	
雜	zá: mixed; miscellaneous; various; to mix;	
時蔬	shí shū: seasonal vegetables;	
肝	gān: liver; CL:葉|叶[ye4],個|个[ge4];	
腳	jiǎo: foot; leg (of an animal or an object); base (of an object); CL:雙|双[shuang1],隻|只[zhi1]; classifier for kicks;  jué: variant of 角[jue2]; role;	
貝	Bèi: surname Bei;  bèi: cowrie; shellfish; currency (archaic);	
魷	yóu: cuttlefish;	
烏	Wū: abbr. for Ukraine 烏克蘭|乌克兰[Wu1 ke4 lan2]; surname Wu;  wū: crow; black;	
熗	qiàng: to stir-fry then cook with sauce and water; to boil food briefly then dress with soy etc; to choke; to irritate (throat etc);	
芋	yù: taro; Colocasia antiquorum; Colocasia esculenta;	
豆豉	dòu chǐ: black bean; black bean sauce;	
蒸餃	zhēng jiǎo: steamed dumpling;	
丸子	wán zi: pills; balls; meatballs;	
板	bǎn: board; plank; plate; shutter; table tennis bat; clappers (music); CL:塊|块[kuai4]; accented beat in Chinese music; hard; stiff; to stop smiling or look serious;  bǎn: see 老闆|老板, boss;  pàn: to catch sight of in a doorway (old);	
饃	mó: small loaf of steamed bread;	
腐竹	fǔ zhú: roll of dried tofu strips;	
腰	yāo: waist; lower back; pocket; middle; loins;	
炝	qiàng: to stir-fry then cook with sauce and water; to boil food briefly then dress with soy etc; to choke; to irritate (throat etc);	
乌	Wū: abbr. for Ukraine 烏克蘭|乌克兰[Wu1 ke4 lan2]; surname Wu;  wū: crow; black;	
鱿	yóu: cuttlefish;	
贝	Bèi: surname Bei;  bèi: cowrie; shellfish; currency (archaic);	
脚	jiǎo: foot; leg (of an animal or an object); base (of an object); CL:雙|双[shuang1],隻|只[zhi1]; classifier for kicks;  jué: variant of 角[jue2]; role;	
时蔬	shí shū: seasonal vegetables;	
豆浆	dòu jiāng: soy milk;	
红茶	hóng chá: black tea; CL:杯[bei1],壺|壶[hu2];	
锅巴	guō bā: guoba (scorched rice at the bottom of the pan);	
浇	jiāo: to pour liquid; to irrigate (using waterwheel); to water; to cast (molten metal); to mold;	
馍	mó: small loaf of steamed bread;  mó: variant of 饃|馍[mo2];	
炸鸡	zhá jī: fried chicken;	
贵妃	guì fēi: senior concubine; imperial consort;	
窝	wō: nest; pit or hollow on the human body; lair; den; place; to harbor or shelter; to hold in check; to bend; classifier for litters and broods;	
葫芦	hú lu: calabash or bottle gourd (Lagenaria siceraria); hoist; generic term for block and tackle (or parts thereof); muddled; (poker) full house;	
蒸饺	zhēng jiǎo: steamed dumpling;	
湖南	Hú nán: Hunan province in south central China, abbr. 湘, capital Changsha 長沙|长沙[Chang2 sha1];	
家常	jiā cháng: the daily life of a family;	
葫蘆	hú lu: calabash or bottle gourd (Lagenaria siceraria); hoist; generic term for block and tackle (or parts thereof); muddled; (poker) full house;	
成都	Chéng dū: Chengdu subprovincial city and capital of Sichuan province 四川 in southwest China;	
六	lìu: six; 6;	
八	bā: eight; 8;	
招牌	zhāo pai: signboard; shop sign; reputation of a business;	
窩	wō: nest; pit or hollow on the human body; lair; den; place; to harbor or shelter; to hold in check; to bend; classifier for litters and broods;	
京都	Jīng dū: Kyoto, Japan;  jīng dū: capital (of a country);	
貴妃	guì fēi: senior concubine; imperial consort;	
生菜	shēng cài: lettuce; raw fresh vegetables; greens;	
炸雞	zhá jī: fried chicken;	
澆	jiāo: to pour liquid; to irrigate (using waterwheel); to water; to cast (molten metal); to mold;	
迷你	mí nǐ: mini (as in mini-skirt or Mini Cooper) (loanword);	
秦	Qín: surname Qin; Qin dynasty (221-207 BC) of the first emperor 秦始皇[Qin2 Shi3 huang2]; abbr. for 陝西|陕西[Shan3 xi1];	
泡	pāo: puffed; swollen; spongy; small lake (esp. in place names); classifier for urine or feces;  pào: bubble; foam; blister (i.e. skin bubble); to soak; to steep; to infuse; to dawdle; to shilly-shally; to hang about; to pick up (a girl); to get off with (a sexual partner);	
鍋巴	guō bā: guoba (scorched rice at the bottom of the pan);	
紅茶	hóng chá: black tea; CL:杯[bei1],壺|壶[hu2];	
草莓	cǎo méi: strawberry; CL:顆|颗[ke1]; (Taiwan) hickey; love bite;	
果	guǒ: fruit; result; resolute; indeed; if really;  guǒ: variant of 果[guo3]; fruit;	
蜂蜜	fēng mì: honey;	
豆漿	dòu jiāng: soy milk;	
芒果	máng guǒ: mango;	
冰沙	bīng shā: slushie; smoothie; crushed ice drink; frappucino;	
魚肚	yú dǔ: fish maw; a food dish made from the swim bladder of fish;	
羊肉串	yáng ròu chuàn: lamb kebab;	
冬瓜	dōng guā: wax gourd (Cucurbitaceae, Benincasa hispida); white gourd; white hairy melon; Chinese squash;	
苦瓜	kǔ guā: bitter melon (bitter gourd, balsam pear, balsam apple, leprosy gourd, bitter cucumber);	
煎蛋	jiān dàn: fried egg;	
燒烤	shāo kǎo: barbecue; to roast;	
肺	fèi: lung; CL:個|个[ge4];	
蓋	Gě: surname Ge;  gài: lid; top; cover; canopy; to cover; to conceal; to build;	
鐵	Tiě: surname Tie;  tiě: iron (metal); arms; weapons; hard; strong; violent; unshakeable; determined; close; tight (slang);	
特	tè: special; unique; distinguished; especially; unusual; very;	
加	Jiā: abbr. for Canada 加拿大[Jia1 na2 da4];  jiā: to add; plus; (used after an adverb such as 不, 大, 稍 etc, and before a disyllabic verb, to indicate that the action of the verb is applied to sth or sb previously mentioned); to apply (restrictions etc) to (sb); to give (support, consideration etc) to (sth);	
小吃	xiǎo chī: snack; refreshments; CL:家[jia1];	
不	bù: (negative prefix); not; no;	
綠豆	lǜ dòu: mung bean;	
木瓜	mù guā: papaya (Carica papaya); genus Chaenomeles of shrubs in the family Rosaceae; Chinese flowering quince (Chaenomeles speciosa);	
牛奶	níu nǎi: cow&#x27;s milk; CL:瓶[ping2],杯[bei1];	
食	shí: to eat; food; animal feed; eclipse;  sì: to feed;	
薯條	shǔ tiáo: french fries; french fried potatoes; chips;	
檸	níng: lemon;	
可樂	kě lè: amusing; entertaining; (loanword) cola;	
珍珠	zhēn zhū: pearl; CL:顆|颗[ke1];	
西湖	Xī hú: Xihu or West lake (place name); West Lake in Hangzhou 杭州, Zhejiang; Xihu or Hsihu township in Miaoli county 苗栗縣|苗栗县[Miao2 li4 xian4], northwest Taiwan;	
蓮藕	lián ǒu: lotus root;	
皮蛋	pí dàn: thousand-year old eggs; preserved eggs;	
海	Hǎi: surname Hai;  hǎi: ocean; sea; CL:個|个[ge4],片[pian4]; great number of people or things; (dialect) numerous;	
冬	dōng: winter;  Dōng: surname Dong;  dōng: (onom.) beating a drum; rat-a-tat;	
肥	féi: fat; fertile; loose-fitting or large; to fertilize; to become rich by illegal means; fertilizer; manure;	
金牌	jīn pái: gold medal; CL:枚[mei2];	
絲瓜	sī guā: luffa (loofah);	
耳	ěr: ear; handle (archaeology); and that is all (classical Chinese);	
夾	jiā: to press from either side; to place in between; to sandwich; to carry sth under armpit; wedged between; between; to intersperse; to mix; to mingle; clip; folder; Taiwan pr. [jia2];  jiá: double-layered; lined (garment);  jià: Taiwan pr. used in 夾生|夹生[jia1 sheng1] and 夾竹桃|夹竹桃[jia1 zhu2 tao2];	
茄	jiā: phonetic character used in loanwords for the sound &quot;jia&quot;, although 夹 is more common;  qié: eggplant;	
節	jiē: see 節骨眼|节骨眼[jie1 gu5 yan3];  jié: festival; holiday; node; joint; section; segment; part; to economize; to save; to abridge; moral integrity; classifier for segments, e.g. lessons, train wagons, biblical verses; CL:個|个[ge4];	
乾煸	gān biān: to stir-fry with oil only (no addition of water);	
籠	lóng: basket; cage; flat bamboo basket used to serve dimsum 點心|点心[dian3 xin5]; to cover; to cage; to embrace; to manipulate through trickery;  lǒng: to cover; to cage; covering; also pr. [long2];	
薑	Jiāng: surname Jiang;  jiāng: ginger;	
菜心	cài xīn: choy sum; Chinese flowering cabbage; stem of any Chinese cabbage;	
油菜	yóu cài: oilseed rape (Brassica napus); flowering edible rape (Brassica chinensis var. oleifera);	
腐	fǔ: decay; rotten;	
拌麵	bàn miàn: noodles served with soy sauce; sesame butter etc;	
油條	yóu tiáo: youtiao (deep-fried breadstick); CL:根[gen1]; slick and sly person;	
西芹	xī qín: celery; parsley;	
星	xīng: star; heavenly body; satellite; small amount;	
東北	Dōng běi: Northeast China; Manchuria;  dōng běi: northeast;	
檸檬雞	níng méng jī: lemon chicken;	
八寶	bā bǎo: eight treasures;	
糊	hú: variant of 糊[hu2];  hú: muddled; paste; scorched;  hù: paste; cream;	
芥菜	jiè cài: mustard (Brassica juncea);	
是	shì: is; are; am; yes; to be;  shì: variant of 是[shi4]; (used in given names);	
例	lì: example; precedent; rule; case; instance;	
唐	Táng: Tang dynasty (618-907); surname Tang;  táng: to exaggerate; empty; in vain; old variant of 螗[tang2];	
釀	niàng: to ferment; to brew; to make honey (of bees); to lead to; to form gradually; wine; stuffed vegetables (cooking method);	
碧綠	bì lǜ: dark green;	
蟹	xiè: crab;  xiè: variant of 蟹[xie4];	
薯	shǔ: potato; yam;  shǔ: variant of 薯[shu3];	
蘭花	lán huā: cymbidium; orchid;	
忌	jì: to be jealous of; fear; dread; scruple; to avoid or abstain from; to quit; to give up sth;	
廉	lián: old variant of 廉[lian2];  lián: old variant of 廉[lian2];  Lián: surname Lian;	
的	de: of; ~&#x27;s (possessive particle); (used after an attribute); (used to form a nominal expression); (used at the end of a declarative sentence for emphasis);  dī: see 的士[di1 shi4];  dí: really and truly;	
烧烤	shāo kǎo: barbecue; to roast;	
盖	Gě: surname Ge;  gài: lid; top; cover; canopy; to cover; to conceal; to build;	
铁	Tiě: surname Tie;  tiě: iron (metal); arms; weapons; hard; strong; violent; unshakeable; determined; close; tight (slang);	
绿豆	lǜ dòu: mung bean;	
薯条	shǔ tiáo: french fries; french fried potatoes; chips;	
柠	níng: lemon;	
可乐	kě lè: amusing; entertaining; (loanword) cola;	
莲藕	lián ǒu: lotus root;	
丝瓜	sī guā: luffa (loofah);	
夹	jiā: to press from either side; to place in between; to sandwich; to carry sth under armpit; wedged between; between; to intersperse; to mix; to mingle; clip; folder; Taiwan pr. [jia2];  jiá: double-layered; lined (garment);  jià: Taiwan pr. used in 夾生|夹生[jia1 sheng1] and 夾竹桃|夹竹桃[jia1 zhu2 tao2];	
节	jiē: see 節骨眼|节骨眼[jie1 gu5 yan3];  jié: festival; holiday; node; joint; section; segment; part; to economize; to save; to abridge; moral integrity; classifier for segments, e.g. lessons, train wagons, biblical verses; CL:個|个[ge4];	
干煸	gān biān: to stir-fry with oil only (no addition of water);	
笼	lóng: basket; cage; flat bamboo basket used to serve dimsum 點心|点心[dian3 xin5]; to cover; to cage; to embrace; to manipulate through trickery;  lǒng: to cover; to cage; covering; also pr. [long2];	
鱼肚	yú dǔ: fish maw; a food dish made from the swim bladder of fish;	
拌面	bàn miàn: noodles served with soy sauce; sesame butter etc;	
油条	yóu tiáo: youtiao (deep-fried breadstick); CL:根[gen1]; slick and sly person;	
东北	Dōng běi: Northeast China; Manchuria;  dōng běi: northeast;	
柠檬鸡	níng méng jī: lemon chicken;	
八宝	bā bǎo: eight treasures;	
煳	hú: burnt; to char;	
酿	niàng: to ferment; to brew; to make honey (of bees); to lead to; to form gradually; wine; stuffed vegetables (cooking method);	
碧绿	bì lǜ: dark green;	
兰花	lán huā: cymbidium; orchid;	
翼	Yì: surname Yi; alternative name for 絳|绛[Jiang4] capital of the Jin State during the Spring and Autumn Period (770-475 BC);  yì: wing; area surrounding the bullseye of a target; to assist; one of the 28 constellations of Chinese astronomy; old variant of 翌;	
鮑魚	bào yú: abalone;	
苑	Yuàn: surname Yuan;  yuàn: park;	
沙茶	shā chá: satay (spicy peanut sauce), also spelled sate;	
位	wèi: position; location; place; seat; classifier for people (honorific); classifier for binary bits (e.g. 十六位 16-bit or 2 bytes);	
日	Rì: abbr. for 日本[Ri4 ben3], Japan;  rì: sun; day; date, day of the month;	
金銀	jīn yín: gold and silver;	
清湯	qīng tāng: broth; clear soup; consommé;	
選擇	xuǎn zé: to select; to pick; choice; option; alternative;	
柳	Lǐu: surname Liu;  lǐu: willow;  lǐu: old variant of 柳[liu3];	
任選	rèn xuǎn: to choose arbitrarily; to take whichever one fancies;	
碗	wǎn: variant of 碗[wan3];  wǎn: variant of 碗[wan3];  wǎn: variant of 碗[wan3];	
泡菜	pào cài: pickled cabbage;	
臊子	sào zi: (dialect) minced or diced meat (as part of a dish);	
麵筋	miàn jīn: gluten;	
蟹粉	xiè fěn: crab meat;	
主料	zhǔ liào: main ingredients (in a cooking recipe);	
任选	rèn xuǎn: to choose arbitrarily; to take whichever one fancies;	
选择	xuǎn zé: to select; to pick; choice; option; alternative;	
清汤	qīng tāng: broth; clear soup; consommé;	
金银	jīn yín: gold and silver;	
鲍鱼	bào yú: abalone;	
酒酿	jǐu niàng: sweet fermented rice; glutinous rice wine;	
咕噜肉	gū lū ròu: sweet and sour meat (pork);	
鸡汤	jī tāng: chicken stock;	
龙	Lóng: surname Long;  lóng: dragon; CL:條|条[tiao2]; imperial;	
白饭	bái fàn: plain cooked rice; rice with nothing to go with it;	
泡馍	pào mó: meat and bread soup (a specialty of Shaanxi cuisine);	
狮子头	shī zi tóu: lit. lion&#x27;s head; pork meatballs;	
鱼丸	yú wán: fish ball;	
面类	miàn lèi: noodle dishes (on menu);	
莴笋	wō sǔn: Chinese lettuce; celtuce; asparagus lettuce; celery lettuce; stem lettuce;	
香肠	xiāng cháng: sausage; CL:根[gen1];	
香腸	xiāng cháng: sausage; CL:根[gen1];	
中	Zhōng: China; Chinese; surname Zhong;  zhōng: within; among; in; middle; center; while (doing sth); during; (dialect) OK; all right;  zhòng: to hit (the mark); to be hit by; to suffer; to win (a prize, a lottery);	
尖	jiān: point (of needle); sharp; shrewd; pointed;	
意	Yì: Italy; Italian; abbr. for 意大利[Yi4 da4 li4];  yì: idea; meaning; thought; to think; wish; desire; intention; to expect; to anticipate;	
西瓜	xī guā: watermelon; CL:顆|颗[ke1],粒[li4],個|个[ge5];	
桔	jié: Platycodon grandiflorus; water bucket;  jú: variant of 橘[ju2];	
港	Gǎng: Hong Kong, abbr. for 香港[Xiang1 gang3]; surname Gang;  gǎng: harbor; port; CL:個|个[ge4];	
紫菜	zǐ cài: flavored roasted seaweed; generic term for edible seaweed; Japanese: nori;	
角	Jué: surname Jue;  jiǎo: angle; corner; horn; horn-shaped; unit of money equal to 0.1 yuan; CL:個|个[ge4];  jué: role (theater); to compete; ancient three legged wine vessel; third note of pentatonic scale;	
香干	xiāng gān: smoked bean curd;	
萵筍	wō sǔn: Chinese lettuce; celtuce; asparagus lettuce; celery lettuce; stem lettuce;	
麵類	miàn lèi: noodle dishes (on menu);	
魚丸	yú wán: fish ball;	
架	jià: to support; frame; rack; framework; classifier for planes, large vehicles, radios etc;	
餐	cān: meal; to eat; classifier for meals;	
蜜桃	mì táo: honey peach; juicy peach;	
蛋白	dàn bái: egg white; protein; albumen;	
夫妻	fū qī: husband and wife; married couple;	
料	liào: material; stuff; grain; feed; to expect; to anticipate; to guess;	
獅子頭	shī zi tóu: lit. lion&#x27;s head; pork meatballs;	
打	dá: dozen (loanword);  dǎ: to beat; to strike; to hit; to break; to type; to mix up; to build; to fight; to fetch; to make; to tie up; to issue; to shoot; to calculate; to play (a game); since; from;	
泡饃	pào mó: meat and bread soup (a specialty of Shaanxi cuisine);	
蹄	tí: hoof; pig&#x27;s trotters;  tí: variant of 蹄[ti2];	
菠菜	bō cài: spinach; CL:棵[ke1];	
白飯	bái fàn: plain cooked rice; rice with nothing to go with it;	
龍	Lóng: surname Long;  lóng: dragon; CL:條|条[tiao2]; imperial;	
雞湯	jī tāng: chicken stock;	
血	xuè: blood; colloquial pr. [xie3]; CL:滴[di1],片[pian4];	
洲	zhōu: continent; island in a river;	
咕嚕肉	gū lū ròu: sweet and sour meat (pork);	
紫	zǐ: purple; violet; amethyst; Lithospermum erythrorhizon (flowering plant whose root provides red purple dye); Japanese: murasaki;	
酒釀	jǐu niàng: sweet fermented rice; glutinous rice wine;	
鸡腿	jī tuǐ: chicken leg; drumstick; CL:根[gen1];	
竹	zhú: bamboo; CL:棵[ke1],支[zhi1],根[gen1];	
時菜	shí cài: seasonal vegetable;	
灼	zhuó: luminous; burning; to burn; to cauterize;	
甜品	tián pǐn: dessert;	
半	bàn: half; semi-; incomplete; (after a number) and a half;	
江	Jiāng: surname Jiang;  jiāng: river; CL:條|条[tiao2],道[dao4];	
卜	Bǔ: surname Bu;  bǔ: to divine; to forecast or estimate; (of a place to live etc) to choose;  bo: see 蘿蔔|萝卜[luo2 bo5];	
治	zhì: to rule; to govern; to manage; to control; to harness (a river); to treat (a disease); to wipe out (a pest); to punish; to research;	
潑	pō: to splash; to spill; rough and coarse; brutish;	
雞毛	jī máo: chicken feather; CL:根[gen1]; trivial;	
只	zhǐ: only; merely; just; but;  zhǐ: but; only;  zhǐ: grain that has begun to ripen; variant of 衹|只[zhi3];	
甜	tián: sweet;	
底	de: (equivalent to 的 as possessive particle);  dǐ: background; bottom; base; end (of the month, year etc); remnants;	
辣椒	là jiāo: hot pepper; chili;	
烤雞	kǎo jī: roast chicken;	
蘆筍	lú sǔn: asparagus;	
手工	shǒu gōng: handwork; manual;	
涼皮	liáng pí: liangpi (noodle-like dish);	
重慶	Chóng qìng: Chongqing city (Chungking), formerly in Sichuan province, a municipality since 1997, short name 渝[Yu2];	
烹	pēng: cooking method; to boil sb alive (capital punishment in imperial China);	
蔬	shū: vegetables;	
塘	táng: dyke; embankment; pool or pond; hot-water bathing pool;	
避風	bì fēng: to take shelter from the wind; to lie low; to stay out of trouble;	
燴	huì: to braise; to cook in soy and vinegar; braised; cooked in soy and vinegar;	
粟米	sù mǐ: corn; maize (dialect);	
元	Yuán: surname Yuan; the Yuan or Mongol dynasty (1279-1368);  yuán: unit of money (in PRC: Chinese yuan, in USA: dollar, etc); primary; first;	
旺	wàng: prosperous; flourishing; (of flowers) blooming; (of fire) roaring;	
北	běi: north; to be defeated (classical);	
疙瘩	gē da: swelling or lump on skin; pimple; knot; preoccupation; problem;	
盒子	hé zi: case;	
合	gě: 100 ml; one-tenth of a peck; measure for dry grain equal to one-tenth of sheng 升 or liter, or one-hundredth dou 斗;  hé: to close; to join; to fit; to be equal to; whole; together; round (in battle); conjunction (astronomy); 1st note of pentatonic scale; old variant of 盒[he2];  hé: variant of 合[he2];	
居	Jū: surname Ju;  jī: (archaic) sentence-final particle expressing a doubting attitude;  jū: to reside; to be (in a certain position); to store up; to be at a standstill; residence; house; restaurant; classifier for bedrooms;	
凍	dòng: to freeze; to feel very cold; aspic or jelly;	
層	céng: layer; stratum; laminated; floor (of a building); storey; classifier for layers; repeated; sheaf (math.);	
泡沫	pào mò: foam; (soap) bubble; (economic) bubble;	
丸	wán: ball; pellet; pill;	
豆皮	dòu pí: dried beancurd (tofu);	
滋味	zī wèi: taste; flavor; feeling;	
肉丁	ròu dīng: diced meat;	
五	wǔ: five; 5;	
粉條	fěn tiáo: vermicelli made from mung bean starch etc;	
東	Dōng: surname Dong;  dōng: east; host (i.e. sitting on east side of guest); landlord;	
魚頭	yú tóu: fish head; fig. upright and unwilling to compromise;	
花蛤	huā gé: clam; bivalve mollusc, many spp.;	
配送	pèi sòng: distribution; delivery;	
地	de: -ly; structural particle: used before a verb or adjective, linking it to preceding modifying adverbial adjunct;  dì: earth; ground; field; place; land; CL:片[pian4];	
烤肉	kǎo ròu: barbecue (lit. roast meat);	
茶樹	chá shù: tea tree; Camellia sinensis;	
菊花	jú huā: chrysanthemum; (slang) anus;	
百香果	bǎi xiāng guǒ: passion fruit;	
沙律	shā lǜ: salad (loanword);	
冷飲	lěng yǐn: cold drink;	
爪	zhuǎ: claw;	
盤	pán: plate; dish; tray; board; hard drive (computing); to build; to coil; to check; to examine; to transfer (property); to make over; classifier for food: dish, helping; to coil; classifier for coils of wire; classifier for games of chess;	
美味	měi wèi: delicious; delicious food; delicacy;	
洋	yáng: ocean; vast; foreign; silver dollar or coin;	
山	Shān: surname Shan;  shān: mountain; hill; anything that resembles a mountain; CL:座[zuo4]; bundled straw in which silkworms spin cocoons; gable;	
毛	Máo: surname Mao;  máo: hair; feather; down; wool; mildew; mold; coarse or semifinished; young; raw; careless; unthinking; nervous; scared; (of currency) to devalue or depreciate; classifier for Chinese fractional monetary unit ( = 角[jiao3] , = one-tenth of a yuan or 10 fen 分[fen1]);	
農家	Nóng jiā: School of Agriculture, school of thought of the Warring States Period (475-221 BC);  nóng jiā: peasant family;	
原	yuán: former; original; primary; raw; level; cause; source;	
膽	dǎn: gall bladder; courage; guts; gall; inner container (e.g. bladder of a football, inner container of a thermos);	
虎	hǔ: tiger; CL:隻|只[zhi1];	
肉末	ròu mò: ground meat;	
鵪鶉	ān chún: quail;	
臘腸	là cháng: sausage;	
雞腿	jī tuǐ: chicken leg; drumstick; CL:根[gen1];	
小黃	xiǎo huáng: (coll.) taxicab (Tw);	
鳳爪	fèng zhǎo: chicken feet (cuisine);	
棒	bàng: stick; club; cudgel; smart; capable; strong; wonderful; classifier for legs of a relay race;	
凤爪	fèng zhǎo: chicken feet (cuisine);	
小黄	xiǎo huáng: (coll.) taxicab (Tw);	
枝	zhī: branch; classifier for sticks, rods, pencils etc;	
腊肠	là cháng: sausage;	
鹌鹑	ān chún: quail;	
胆	dǎn: gall bladder; courage; guts; gall; inner container (e.g. bladder of a football, inner container of a thermos);	
农家	Nóng jiā: School of Agriculture, school of thought of the Warring States Period (475-221 BC);  nóng jiā: peasant family;	
盘	pán: plate; dish; tray; board; hard drive (computing); to build; to coil; to check; to examine; to transfer (property); to make over; classifier for food: dish, helping; to coil; classifier for coils of wire; classifier for games of chess;	
冷饮	lěng yǐn: cold drink;	
茶树	chá shù: tea tree; Camellia sinensis;	
鱼头	yú tóu: fish head; fig. upright and unwilling to compromise;	
东	Dōng: surname Dong;  dōng: east; host (i.e. sitting on east side of guest); landlord;	
粉条	fěn tiáo: vermicelli made from mung bean starch etc;	
层	céng: layer; stratum; laminated; floor (of a building); storey; classifier for layers; repeated; sheaf (math.);	
冻	dòng: to freeze; to feel very cold; aspic or jelly;	
烩	huì: to braise; to cook in soy and vinegar; braised; cooked in soy and vinegar;	
避风	bì fēng: to take shelter from the wind; to lie low; to stay out of trouble;	
重庆	Chóng qìng: Chongqing city (Chungking), formerly in Sichuan province, a municipality since 1997, short name 渝[Yu2];	
凉皮	liáng pí: liangpi (noodle-like dish);	
新鲜	xīn xiān: fresh (experience, food etc); freshness; novel; uncommon;	
外卖	wài mài: to go; take out (relates to food bought at a restaurant);	
虾米	xiā mǐ: small shrimp; dried, shelled shrimps;	
油鸡	yóu jī: a variety of chicken;	
鲍	Bào: surname Bao;  bào: abalone;	
自选	zì xuǎn: to choose by oneself; free to choose; optional; self-service;	
时菜	shí cài: seasonal vegetable;	
泼	pō: to splash; to spill; rough and coarse; brutish;	
鸡毛	jī máo: chicken feather; CL:根[gen1]; trivial;	
烤鸡	kǎo jī: roast chicken;	
芦笋	lú sǔn: asparagus;	
新鮮	xīn xiān: fresh (experience, food etc); freshness; novel; uncommon;	
外賣	wài mài: to go; take out (relates to food bought at a restaurant);	
葱	cōng: scallion; green onion;	
蕃茄	fān qié: variant of 番茄[fan1 qie2];	
棠	táng: cherry-apple;	
牛蛙	níu wā: bullfrog;	
杏仁	xìng rén: almond; apricot kernel;	
香菜	xiāng cài: coriander; cilantro; Coriandrum sativum;	
犁	lí: plow;	
啫	zhě: particle used for interjection (Cantonese); see also 啫哩[zhe3 li1];	
蝦米	xiā mǐ: small shrimp; dried, shelled shrimps;	
姜	Jiāng: surname Jiang;  Jiāng: surname Jiang;  jiāng: ginger;	
油雞	yóu jī: a variety of chicken;	
鮑	Bào: surname Bao;  bào: abalone;	
用	yòng: to use; to employ; to have to; to eat or drink; expense or outlay; usefulness; hence; therefore;	
足	jù: excessive;  zú: foot; to be sufficient; ample;	
自選	zì xuǎn: to choose by oneself; free to choose; optional; self-service;	
以下	yǐ xià: that level or lower; that amount or less; the following;	
奶油	nǎi yóu: cream; butter;	
沙拉	shā lā: salad (loanword);	
沙爹	shā diē: satay (sauce);	
浸	jìn: to immerse; to soak; to steep; gradually;	
潮	cháo: tide; current; damp; moist; humid;	
飲料	yǐn liào: drink; beverage;	
發	fā: to send out; to show (one&#x27;s feeling); to issue; to develop; classifier for gunshots (rounds);	
供	gōng: to provide; to supply;  gòng: sacrificial offering; to confess;	
州	zhōu: prefecture; (old) province; (old) administrative division; state (e.g. of US); oblast (Russia); canton (Switzerland);	
葡萄酒	pú tao jǐu: (grape) wine;	
海參	hǎi shēn: sea cucumber;	
抄手	chāo shǒu: to fold one&#x27;s arms; copyist; (dialect) wonton;	
湯圓	tāng yuán: boiled balls of glutinous rice flour, eaten during the Lantern festival;	
豆花	dòu huā: douhua; type of bean curd;	
風味	fēng wèi: distinctive flavor; distinctive style;	
飄	piāo: to float;	
涼粉	liáng fěn: liangfen (Chinese dish); grass jelly (Chinese dish);	
冷盤	lěng pán: cold plate; cold meats;	
酸梅	suān méi: pickled plum; Japanese umeboshi;	
茴香	huí xiāng: fennel (Foeniculum vulgare);	
燒餅	shāo bing: baked sesame seed-coated cake;	
按	àn: to press; to push; to leave aside or shelve; to control; to restrain; to keep one&#x27;s hand on; to check or refer to; according to; in the light of; (of an editor or author) to make a comment;	
丁	Dīng: surname Ding;  dīng: fourth of the ten Heavenly Stems 十天干[shi2 tian1 gan1]; fourth in order; letter &quot;D&quot; or roman &quot;IV&quot; in list &quot;A, B, C&quot;, or &quot;I, II, III&quot; etc; butyl; cubes (of food);	
主食	zhǔ shí: main food; staple (rice and noodles);	
糟	zāo: dregs; draff; pickled in wine; rotten; messy; ruined;	
燉	dùn: to stew;	
豆腐腦	dòu fu nǎo: jellied tofu; soft bean curd;	
里脊	lǐ ji: (tender)loin (of pork, beef etc);	
芫	yuán: lilac daphne (Daphne genkwa), used in Chinese herbal medicine;	
滋補	zī bǔ: nourishing; nutritious;	
烤鴨	kǎo yā: roast duck;	
健	jiàn: healthy; to invigorate; to strengthen; to be good at; to be strong in;	
豆沙包	dòu shā bāo: bean paste bun;	
炒面	chǎo miàn: stir-fried noodles; &quot;chow mein&quot;;	
切	qiē: to cut; to slice; tangent (math);  qiè: definitely; absolutely (not); (scoffing or dismissive interjection) Yeah, right.; Tut!; to grind; close to; eager; to correspond to; see also 反切[fan3 qie4];	
麵食	miàn shí: food made from wheat flour, such as noodles, dumplings, buns etc;	
炸魚	zhá yú: deep-fried fish;	
雞排	jī pái: chicken breast; chicken cutlet;	
茭白	jiāo bái: water bamboo; wild rice shoots;	
鳕鱼	xuě yú: cod;	
肠粉	cháng fěn: rice noodle roll, a roll made from sheets of rice flour dough, steamed and stuffed with meat, vegetables etc;	
点心	diǎn xin: light refreshments; pastry; dimsum (in Cantonese cooking); dessert;	
荠菜	jì cài: shepherd&#x27;s purse (Capsella bursa-pastoris);	
宽	Kuān: surname Kuan;  kuān: lenient; wide; broad;	
蛋黄	dàn huáng: egg yolk;	
步骤	bù zhòu: procedure; step;	
有机	yǒu jī: organic;	
米線	mǐ xiàn: rice-flour noodles;	
炒菜	chǎo cài: stir-fried dish;	
剁	duò: to chop (meat); to cut;	
瘦肉	shòu ròu: lean meat;	
台式	tái shì: (of an appliance) tabletop model; (of a computer) desktop model;	
乾媽	gān mā: godmother;	
有	yǒu: to have; there is; there are; to exist; to be;	
黃豆	huáng dòu: soybean;	
板栗	bǎn lì: Chinese chestnut;	
罐	guàn: can; jar; pot;  guàn: variant of 罐[guan4];	
瓦	wǎ: roof tile; abbr. for 瓦特[wa3 te4], watt (loan);	
多	duō: many; much; often; a lot of; numerous; more; in excess; how (to what extent); multi-; Taiwan pr. [duo2] when it means &quot;how&quot;;	
梅子	méi zi: plum;	
拍	pāi: to pat; to clap; to slap; to swat; to take (a photo); to shoot (a film); racket (sports); beat (music);	
口水	kǒu shuǐ: saliva;	
火爆	huǒ bào: fiery (temper); popular; flourishing; prosperous; lively;	
勺	sháo: spoon; ladle; CL:把[ba3]; abbr. for 公勺[gong1 shao2], centiliter (unit of volume);	
猪肉	zhū ròu: pork;	
兩面	liǎng miàn: both sides;	
拉皮	lā pí: to have a facelift; facelift;	
羊排	yáng pái: lamb chop;	
新疆	Xīn jiāng: Xinjiang; Uighur autonomous region 新疆維吾爾自治區|新疆维吾尔自治区;	
生煎包	shēng jiān bāo: pan-fried dumpling;	
咕	gū: (onom.) for the sound of a bird, an empty stomach etc;	
咾	lǎo: a noise; a sound;	
塔	tǎ: pagoda; tower; minaret; stupa (abbr. loanword from Sanskrit tapo); CL:座[zuo4];  tǎ: old variant of 塔[ta3];	
斑	bān: spot; colored patch; stripe; spotted; striped; variegated;	
胡椒	hú jiāo: pepper;	
松	Sōng: surname Song;  sōng: pine; CL:棵[ke1];  sōng: loose; to loosen; to relax;	
養生	yǎng shēng: to maintain good health; to raise a child or animal; curing (of concrete etc);	
銀耳	yín ěr: white fungus (Tremella fuciformis); silver tree-ear fungus;	
自製	zì zhì: self-made; improvised; homemade; handmade;	
越	Yuè: generic word for peoples or states of south China or south Asia at different historical periods; abbr. for Vietnam 越南;  yuè: to exceed; to climb over; to surpass; the more... the more;	
桂花	guì huā: osmanthus flowers; Osmanthus fragrans;	
明蝦	míng xiā: prawn;	
遠	yuǎn: far; distant; remote; (intensifier in a comparison) by far; much (lower etc);  yuàn: to distance oneself from (classical);	
明	Míng: Ming Dynasty (1368-1644); surname Ming; Ming (c. 2000 BC), fourth of the legendary Flame Emperors, 炎帝[Yan2 di4] descended from Shennong 神農|神农[Shen2 nong2] Farmer God;  míng: bright; opposite: dark 暗[an4]; (of meaning) clear; to understand; next; public or open; wise; generic term for a sacrifice to the gods;	
菜脯	cài pú: dried, pickled white radish;	
家鄉	jiā xiāng: hometown; native place; CL:個|个[ge4];	
粗	cū: coarse; rough; thick (for cylindrical objects); unfinished; vulgar; rude; crude;  cū: variant of 粗[cu1];  cū: remote; distant; variant of 粗[cu1];	
菠蘿	bō luó: pineapple;	
款	kuǎn: section; paragraph; funds; CL:筆|笔[bi3],個|个[ge4]; classifier for versions or models (of a product);	
頸	jǐng: neck;	
泰	Tài: Mt Tai 泰山[Tai4 Shan1] in Shandong; abbr. for Thailand;  tài: safe; peaceful; most; grand;	
炆	wén: (Cantonese) to simmer; to cook over a slow fire;	
腐乳	fǔ rǔ: pickled tofu;	
野	yě: old variant of 野[ye3];  yě: erroneous variant of 野[ye3];  yě: field; plain; open space; limit; boundary; rude; feral;	
染	rǎn: to dye; to catch (a disease); to acquire (bad habits etc); to contaminate; to add color washes to a painting;	
銀魚	yín yú: oriental whitebait; slender silvery-white fish e.g. Galaxias maculatus and Salangichthys microdon;	
兩	liǎng: two; both; some; a few; tael, unit of weight equal to 50 grams (modern) or 1⁄16 of a catty 斤[jin1] (old);	
鱈魚	xuě yú: cod;	
葡	Pú: Portugal; Portuguese; abbr. for 葡萄牙[Pu2 tao2 ya2];  pú: see 葡萄[pu2 tao5];	
腸粉	cháng fěn: rice noodle roll, a roll made from sheets of rice flour dough, steamed and stuffed with meat, vegetables etc;	
陜	xiá: variant of 狹|狭 narrow; variant of 峽|峡 gorge; used erroneously for 陝|陕 Shaanxi;	
桃	táo: peach;	
如	rú: as; as if; such as;	
岐山	Qí shān: Qishan County in Baoji 寶雞|宝鸡[Bao3 ji1], Shaanxi;	
海蜇	hǎi zhé: Rhopilema esculenta, an edible jellyfish;	
點心	diǎn xin: light refreshments; pastry; dimsum (in Cantonese cooking); dessert;	
薺菜	jì cài: shepherd&#x27;s purse (Capsella bursa-pastoris);	
寬	Kuān: surname Kuan;  kuān: lenient; wide; broad;	
蛋黃	dàn huáng: egg yolk;	
步驟	bù zhòu: procedure; step;	
你	nǐ: you (informal, as opposed to courteous 您[nin2]);	
有機	yǒu jī: organic;	
大三	dà sān: third-year university student;	
芥末	jiè mo: mustard; wasabi;	
脖	bó: neck;	
瓜子	guā zǐ: melon seeds;	
口味	kǒu wèi: a person&#x27;s preferences; tastes (in food); flavor;	
水煙	shuǐ yān: shredded tobacco for water pipes;	
青島	Qīng dǎo: Qingdao, subprovincial city in Shandong;	
裕	yù: abundant;	
張	Zhāng: surname Zhang;  zhāng: to open up; to spread; sheet of paper; classifier for flat objects, sheet; classifier for votes;	
柚子	yòu zi: pomelo (Citrus maxima or C. grandis); shaddock; oriental grapefruit;	
芽	yá: bud; sprout;	
紅棗	hóng zǎo: jujube; red date;	
壺	hú: pot; classifier for bottled liquid;	
大蒜	dà suàn: garlic;	
肉類	ròu lèi: meat;	
韭	jǐu: leek;  jǐu: variant of 韭[jiu3];	
火腿腸	huǒ tuǐ cháng: ham sausage;	
鯽魚	jì yú: Crucian carp;	
青岛	Qīng dǎo: Qingdao, subprovincial city in Shandong;	
水烟	shuǐ yān: shredded tobacco for water pipes;	
干妈	gān mā: godmother;	
米线	mǐ xiàn: rice-flour noodles;	
鸡排	jī pái: chicken breast; chicken cutlet;	
炸鱼	zhá yú: deep-fried fish;	
面食	miàn shí: food made from wheat flour, such as noodles, dumplings, buns etc;	
烤鸭	kǎo yā: roast duck;	
滋补	zī bǔ: nourishing; nutritious;	
里嵴	Unknown	
豆腐脑	dòu fu nǎo: jellied tofu; soft bean curd;	
炖	dùn: to stew;	
烧饼	shāo bing: baked sesame seed-coated cake;	
冷盘	lěng pán: cold plate; cold meats;	
飘	piāo: variant of 飄|飘[piao1];  piāo: to float;	
风味	fēng wèi: distinctive flavor; distinctive style;	
汤圆	tāng yuán: boiled balls of glutinous rice flour, eaten during the Lantern festival;	
海参	hǎi shēn: sea cucumber;	
发	fā: to send out; to show (one&#x27;s feeling); to issue; to develop; classifier for gunshots (rounds);  fà: hair; Taiwan pr. [fa3];	
饮料	yǐn liào: drink; beverage;	
两面	liǎng miàn: both sides;	
养生	yǎng shēng: to maintain good health; to raise a child or animal; curing (of concrete etc);	
银耳	yín ěr: white fungus (Tremella fuciformis); silver tree-ear fungus;	
明虾	míng xiā: prawn;	
远	yuǎn: far; distant; remote; (intensifier in a comparison) by far; much (lower etc);  yuàn: to distance oneself from (classical);	
家乡	jiā xiāng: hometown; native place; CL:個|个[ge4];	
菠萝	bō luó: pineapple;	
颈	jǐng: neck;	
银鱼	yín yú: oriental whitebait; slender silvery-white fish e.g. Galaxias maculatus and Salangichthys microdon;	
两	liǎng: two; both; some; a few; tael, unit of weight equal to 50 grams (modern) or 1⁄16 of a catty 斤[jin1] (old);	
鲫鱼	jì yú: Crucian carp;	
火腿肠	huǒ tuǐ cháng: ham sausage;	
肉类	ròu lèi: meat;	
壶	hú: pot; classifier for bottled liquid;	
红枣	hóng zǎo: jujube; red date;	
张	Zhāng: surname Zhang;  zhāng: to open up; to spread; sheet of paper; classifier for flat objects, sheet; classifier for votes;	
麩	fū: bran;	
国	Guó: surname Guo;  guó: country; nation; state; national; CL:個|个[ge4];	
日本	Rì běn: Japan; Japanese;	
豆苗	dòu miáo: pea shoots; bean seedling;	
價目	jià mù: (marked) price; tariff (in a restaurant etc);	
表	biǎo: exterior surface; family relationship via females; to show (one&#x27;s opinion); a model; a table (listing information); a form; a meter (measuring sth);  biǎo: wrist or pocket watch;	
平菇	píng gū: oyster mushroom;	
蒜苗	suàn miáo: garlic shoot; garlic sprouts;	
美	Měi: the Americas; abbr. for 美洲[Mei3 zhou1]; USA; abbr. for 美國|美国[Mei3 guo2];  měi: beautiful; very satisfactory; good; to beautify; to be pleased with oneself;	
另加	lìng jiā: to add to; supplementary;	
肉沫	ròu mò: minced pork;	
酒水	jǐu shuǐ: beverage; a drink;	
單	Shàn: surname Shan;  dān: bill; list; form; single; only; sole; odd number; CL:個|个[ge4];	
冷	Lěng: surname Leng;  lěng: cold;	
桂圓	guì yuán: see 龍眼|龙眼[long2 yan3];	
極品	jí pǐn: best quality;	
水果	shuǐ guǒ: fruit; CL:個|个[ge4];	
洞	dòng: cave; hole; zero (unambiguous spoken form when spelling out numbers); CL:個|个[ge4];	
烏龍	wū lóng: black dragon; unexpected mistake or mishap; oolong (tea); udon (loanword from Japanese);	
基	jī: base; foundation; basic; radical (chemistry);	
椰	yē: coconut palm; Taiwan pr. [ye2];	
曼	màn: handsome; large; long;	
荷	Hé: Holland; the Netherlands; abbr. for 荷蘭|荷兰[He2 lan2];  hé: lotus;  hè: to carry on one&#x27;s shoulder or back; burden; responsibility;	
巴	Bā: Ba state during Zhou dynasty (in east of modern Sichuan); abbr. for east Sichuan or Chongqing; surname Ba; abbr. for Palestine or Palestinian; abbr. for Pakistan;  bā: to long for; to wish; to cling to; to stick to; sth that sticks; close to; next to; spread open; informal abbr. for bus 巴士[ba1 shi4]; bar (unit of pressure); nominalizing suffix on certain nouns, such as 尾巴[wei3 ba5], tail;	
鴛鴦	yuān yāng: (Chinese bird species) mandarin duck (Aix galericulata); affectionate couple; happily married couple;	
選	xuǎn: to choose; to pick; to select; to elect;	
瑪	mǎ: agate; cornelian;	
歌	gē: song; CL:支[zhi1],首[shou3]; to sing;  gē: variant of 歌[ge1];	
喜力	Xǐ lì: Heineken (Dutch brewing company); see also 海尼根[Hai3 ni2 gen1];	
純	chún: pure; simple; unmixed; genuine;	
華	Huá: abbr. for China;  Huà: Mt Hua 華山|华山 in Shaanxi; surname Hua;  huā: old variant of 花[hua1]; flower;	
士	Shì: surname Shi;  shì: member of the senior ministerial class (old); scholar (old); bachelor; honorific; first class military rank; specialist worker;	
方	Fāng: surname Fang;  fāng: square; power or involution (mathematics); upright; honest; fair and square; direction; side; party (to a contract, dispute etc); place; method; prescription (medicine); just when; only or just; classifier for square things; abbr. for square or cubic meter;	
尾	wěi: tail; remainder; remnant; extremity; sixth of the 28 constellations; classifier for fish;  yǐ: horse&#x27;s tail; pointed posterior section of a locust etc;	
香蕉	xiāng jiāo: banana; CL:枝[zhi1],根[gen1],個|个[ge4],把[ba3];	
熱飲	rè yǐn: hot drink;	
含	hán: to keep; to contain; to suck (keep in your mouth without chewing);	
任何	rèn hé: any; whatever; whichever; whatsoever;	
鳳梨	fèng lí: pineapple;	
榨	zhà: variant of 榨[zha4]; to press; to extract (juice);  zhà: to press; to extract (juice); device for extracting juice, oils etc;	
果汁	guǒ zhī: fruit juice;	
甘	Gān: surname Gan; abbr. for Gansu Province 甘肅省|甘肃省[Gan1 su4 Sheng3];  gān: sweet; willing;	
青瓜	qīng guā: cucumber;	
水晶	shuǐ jīng: crystal;	
園	Yuán: surname Yuan;  yuán: land used for growing plants; site used for public recreation;	
薄荷	bò he: field mint; peppermint;	
七	qī: seven; 7;	
仙草	xiān cǎo: medicinal herb (genus Mesona); grass jelly;	
好	hǎo: good; well; proper; good to; easy to; very; so; (suffix indicating completion or readiness); (of an unmarried couple) to be close; to be keen on each other;  hào: to be fond of; to have a tendency to; to be prone to;	
立	Lì: surname Li;  lì: to stand; to set up; to establish; to lay down; to draw up; at once; immediately;	
克	kè: to be able to; to subdue; to restrain; to overcome; gram; Tibetan unit of land area, about 6 ares;  Kè: Ke (c. 2000 BC), seventh of the legendary Flame Emperors, 炎帝[Yan2 di4] descended from Shennong 神農|神农[Shen2 nong2] Farmer God;  kè: variant of 克[ke4]; to subdue; to overthrow; to restrain;	
阿	A: abbr. for Afghanistan 阿富汗[A1 fu4 han4];  ā: prefix used before monosyllabic names, kinship terms etc to indicate familiarity; used in transliteration; also pr. [a4];  ē: flatter;	
田	Tián: surname Tian;  tián: field; farm; CL:片[pian4];	
飲	yǐn: to drink;  yìn: to give (animals) water to drink;	
蝦皮	xiā pí: small dried shrimp;	
天麻	tiān má: Gastrodia elata (botany);	
烏雞	wū jī: black-boned chicken; silky fowl; silkie; Gallus gallus domesticus Brisson;	
煨	wēi: to simmer; to roast in ashes;	
墨魚	mò yú: squid; ink fish; cuttlefish;	
雪梨	Xuě lí: Sydney, capital of New South Wales, Australia (Tw);  xuě lí: snow pear (pyrus nivalis);	
橄欖	gǎn lǎn: Chinese olive; olive;	
芙蓉	Fú róng: Furong district of Changsha city 長沙市|长沙市[Chang2 sha1 shi4], Hunan; Seremban, capital of Sembilan state 森美蘭|森美兰[Sen1 mei3 lan2], Malaysia;  fú róng: hibiscus; cotton rose (Hibiscus mutabilis); lotus; foo yung (type of omelet made of egg white);	
回鍋	huí guō: to cook again; to rewarm food;	
中式	Zhōng shì: Chinese style;  zhòng shì: to pass an exam (or the imperial exam); to qualify;	
滷肉	lǔ ròu: stewed meat;	
法式	Fǎ shì: French style;  fǎ shì: rule; method; model;	
以上	yǐ shàng: that level or higher; that amount or more; the above-mentioned;	
七彩	qī cǎi: seven colors; a variety of colors; multi-colored; rainbow-colored;	
田雞	tián jī: frog; the Chinese edible frog (Hoplobatrachus rugulosus);	
香滑	xiāng huá: creamy;	
品	pǐn: article; commodity; product; goods; kind; grade; rank; character; disposition; nature; temperament; variety; to taste sth; to sample; to criticize; to comment; to judge; to size up;	
仔姜	zǐ jiāng: stem ginger;	
將	jiāng: will; shall; to use; to take; to checkmate; just a short while ago; (introduces object of main verb, used in the same way as 把[ba3]);  jiàng: general; commander-in-chief (military); king (chess piece); to command; to lead;  qiāng: to desire; to invite; to request;	
秘	mì: variant of 秘[mi4];  bì: see 秘魯|秘鲁[Bi4 lu3];  mì: secret; secretary;	
紅燒肉	hóng shāo ròu: red braised pork;	
盆	pén: basin; flower pot; unit of volume equal to 12 斗 and 8 升, approx 128 liters; CL:個|个[ge4];	
骨肉	gǔ ròu: blood relation; kin; one&#x27;s flesh and blood;	
相連	xiāng lián: to link; to join; link; connection;	
營養	yíng yǎng: nutrition; nourishment; CL:種|种[zhong3];	
冷麵	lěng miàn: naengmyeon (Korean dish based on cold noodles in soup);	
餛飩	hún tun: wonton; Taiwan pr. [hun2 dun5];	
店	diàn: inn; shop; store; CL:家[jia1];	
大餅	dà bǐng: large flat bread;	
千	qiān: thousand;  qiān: a swing;	
攪和	jiǎo huo: to mix (up); to blend; to spoil;	
蜇	zhē: to sting;  zhé: jellyfish;	
山藥	shān yao: Dioscorea opposita; yam;	
焦	Jiāo: surname Jiao;  jiāo: burnt; scorched; charred; worried; anxious; coke;	
火燒	huǒ shāo: to set fire to; to burn down; burning hot; baked cake;	
爆肚	bào dǔ: deep fried tripe;	
黃花魚	huáng huā yú: yellow croaker (fish); corvina;	
家常菜	jiā cháng cài: home cooking;	
熏肉	xūn ròu: bacon;	
扁豆	biǎn dòu: hyacinth bean; haricot;	
烙餅	lào bǐng: pancake; flat bread; griddle cake;	
萬	Wàn: surname Wan;  wàn: ten thousand; a great number;	
興	Xīng: surname Xing;  xīng: to rise; to flourish; to become popular; to start; to encourage; to get up; (often used in the negative) to permit or allow (dialect); maybe (dialect);  xìng: feeling or desire to do sth; interest in sth; excitement;	
特價	tè jià: special price;	
醬油	jiàng yóu: soy sauce;	
飲品	yǐn pǐn: beverage;	
燕京	Yān jīng: Yanjing, an old name for Beijing; capital of Yan at different periods;	
酸奶	suān nǎi: yogurt;	
兔	tù: variant of 兔[tu4];  tù: rabbit;	
五更	wǔ gēng: fifth of the five night watch periods 03:00-05:00 (old);	
嫩	nèn: tender; soft; delicate; light (color); inexperienced; unskilled;  nèn: old variant of 嫩[nen4]; tender; delicate;	
涼麵	liáng miàn: cold noodles;	
魔	mó: devil; magic;	
樟	zhāng: camphor; Cinnamonum camphara;	
螞蟻	mǎ yǐ: ant;	
樹	shù: tree; CL:棵[ke1]; to cultivate; to set up;	
紹	Shào: surname Shao;  shào: to continue; to carry on;	
橙	chéng: orange tree; orange (color);	
開	kāi: to open; to start; to turn on; to boil; to write out (a prescription, check, invoice etc); to operate (vehicle); abbr. for 開爾文|开尔文 degrees Kelvin;	
圓	yuán: circle; round; circular; spherical; (of the moon) full; unit of Chinese currency (Yuan); tactful; to justify;	
天津	Tiān jīn: Tianjin, a municipality in northeast China, abbr. 津;	
清燉	qīng dùn: to stew meat without seasoning;	
糖醋魚	táng cù yú: sweet and sour fish;	
燉肉	dùn ròu: stewed meat; beef stew;	
怡	yí: harmony; pleased;	
喜	xǐ: to be fond of; to like; to enjoy; to be happy; to feel pleased; happiness; delight; glad;	
腱	jiàn: tendon; sinew;	
燻	xūn: variant of 熏[xun1];	
兩樣	liǎng yàng: two kinds; difference;	
生水	shēng shuǐ: unboiled water;	
餃	jiǎo: dumplings with meat filling;	
盒	hé: small box; case;	
速凍	sù dòng: to quick-freeze;	
份	fèn: classifier for gifts, newspaper, magazine, papers, reports, contracts etc; variant of 分[fen4];	
錫	xī: tin (chemistry); to bestow; to confer; to grant; Taiwan pr. [xi2];	
紙	zhǐ: paper; CL:張|张[zhang1],沓[da2]; classifier for documents, letter etc;	
漢口	Hàn kǒu: Hankou, part of Wuhan 武漢|武汉 at the junction of Han river and Changjiang in Hubei;	
春捲	chūn juǎn: egg roll; spring roll;	
火紅	huǒ hóng: fiery; blazing;	
東坡	Dōng pō: Dongpo District of Meishan City 眉山市[Mei2 shan1 Shi4], Sichuan;	
廚師	chú shī: cook; chef;	
湘	Xiāng: abbr. for Hunan 湖南 province in south central China; abbr. for Xiangjiang river in Hunan province;	
五香	wǔ xiāng: five spice seasoned; incorporating the five basic flavors of Chinese cooking (sweet, sour, bitter, savory, salty);	
五彩	wǔ cǎi: five (main) colors (white, black, red, yellow, and blue); multicolored;	
糙米	cāo mǐ: brown rice;	
麵點	miàn diǎn: pastry;	
蓮	lián: lotus;	
塊	kuài: lump (of earth); chunk; piece; classifier for pieces of cloth, cake, soap etc; (coll.) classifier for money and currency units;	
大小	dà xiǎo: dimension; magnitude; size; measurement; large and small; at any rate; adults and children; consideration of seniority;	
計	Jì: surname Ji;  jì: to calculate; to compute; to count; to regard as important; to plan; ruse; meter; gauge;	
熏	xūn: to smoke; to fumigate; to assail the nostrils; to perfume;  xūn: variant of 熏[xun1];  xūn: fragrance; warm; to educate; variant of 熏[xun1]; to smoke; to fumigate;	
發麵	fā miàn: to leaven dough; to make bread;	
黑糖	hēi táng: unrefined sugar; brown sugar;	
油花	yóu huā: grease or fat blobs at the surface of a liquid; tricky and dissolute;	
豆渣	dòu zhā: soybean dregs;	
蔓	mán: turnip; Brassica campestris;  màn: creeper; to spread;	
混合	hùn hé: to mix; to blend;	
衣	yī: clothes; CL:件[jian4];  yì: to dress; to wear; to put on (clothes);	
玉	yù: jade;	
鹽水	Yán shuǐ: Yanshui town in Tainan county 台南縣|台南县[Tai2 nan2 xian4], Taiwan;	
爐火	lú huǒ: the fire of a stove;	
濕	shī: moist; wet;	
齋	zhāi: to fast or abstain from meat, wine etc; vegetarian diet; study room; building; to give alms (to a monk);	
大地	dà dì: earth; mother earth;	
線	xiàn: thread; string; wire; line; CL:條|条[tiao2],股[gu3],根[gen1];	
伊	Yī: surname Yi; abbr. for 伊拉克[Yi1 la1 ke4], Iraq; abbr. for 伊朗[Yi1 lang3], Iran;  yī: he; she;	
桶	tǒng: bucket; (trash) can; barrel (of oil etc); CL:個|个[ge4],隻|只[zhi1];	
馬拉	Mǎ lā: Marat (name); Jean-Paul Marat (1743-1793), Swiss scientist and physician;	
盞	zhǎn: a small cup; classifier for lamps;	
鹹菜	xián cài: salted vegetables; pickles;	
東江	Dōng jiāng: Dongjiang River;	
時價	shí jià: current price;	
烹飪	pēng rèn: cooking; culinary arts;	
古	Gǔ: surname Gu;  gǔ: ancient; old; paleo-;	
豉油	chǐ yóu: soy sauce;	
花雕	huā diāo: Shaoxing yellow wine;	
錦繡	jǐn xìu: beautiful;	
拼盤	pīn pán: sampler platter; appetizer platter;	
曰	yuē: to speak; to say;	
蚌	Bèng: abbr. for Bengbu prefecture level city 蚌埠市[Beng4 bu4 shi4], Anhui;  bàng: mussel; clam;	
游水	yóu shuǐ: to swim;	
膠	jiāo: to glue; glue; gum; rubber;	
扣	kòu: to fasten; to button; button; buckle; knot; to arrest; to confiscate; to deduct (money); discount; to knock; to smash, spike or dunk (a ball); to cover (with a bowl etc); fig. to tag a label on sb;  kòu: button;	
飯類	fàn lèi: rice dishes (on menu);	
街坊	jiē fāng: neighborhood;	
焗飯	jú fàn: rice au gratin;	
國	Guó: surname Guo;  guó: country; nation; state; national; CL:個|个[ge4];	
通	tōng: to go through; to know well; (suffix) expert; to connect; to communicate; open; to clear; classifier for letters, telegrams, phone calls etc;  tòng: classifier for an activity, taken in its entirety (tirade of abuse, stint of music playing, bout of drinking etc);	
多士	duō shì: toast (loanword);	
下午	xià wǔ: afternoon; CL:個|个[ge4]; p.m.;	
宵夜	xiāo yè: midnight snack; late-night snack;	
餐點	cān diǎn: food; dish; meal;	
附送	fù sòng: to include (as a free gift, when buying sth); to come with;	
口	kǒu: mouth; classifier for things with mouths (people, domestic animals, cannons, wells etc); classifier for bites or mouthfuls;	
胗	zhēn: gizzard;	
一品	yī pǐn: superb; first-rate; (of officials in imperial times) the highest rank;	
鳳	Fèng: surname Feng;  fèng: phoenix;	
抓	zhuā: to grab; to catch; to arrest; to snatch; to scratch;	
水盆	shuǐ pén: basin;	
餄餎	hé le: noodles either made of buckwheat or sorghum;	
年年	nián nián: year after year; yearly; every year; annually;	
天鵝	tiān é: swan;	
毛筆	máo bǐ: writing brush; CL:枝[zhi1],管[guan3];	
西安	Xī ān: Xi&#x27;an, sub-provincial city and capital of Shaanxi 陝西省|陕西省[Shan3 xi1 Sheng3] in northwest China; see 西安區|西安区[Xi1 an1 qu1];	
開口	kāi kǒu: to open one&#x27;s mouth; to start to talk;	
笑	xiào: old variant of 笑[xiao4];  xiào: laugh; smile; CL:個|个[ge4];	
吉	Jí: surname Ji; abbr. for Jilin Province 吉林省[Ji2 lin2 Sheng3];  jí: lucky; giga- (meaning billion or 10^9);	
地瓜	dì guā: sweet potato (Ipomoea batatas); yam (family Dioscoreaceae);	
汽水	qì shuǐ: soda; pop;	
熱茶	rè chá: hot tea;	
外面	wài miàn: surface; exterior; external appearance;  wài mian: outside;	
帶	dài: band; belt; girdle; ribbon; tire; area; zone; region; CL:條|条[tiao2]; to wear; to carry; to take along; to bear (i.e. to have); to lead; to bring; to look after; to raise;	
醉雞	zuì jī: chicken in rice wine; also translated drunken chicken;	
制	zhì: system; to control; to regulate; variant of 製|制[zhi4];  zhì: to manufacture; to make;	
百合	bǎi hé: lily;	
贴	tiē: to stick; to paste; to post (e.g. on a blog); to keep close to; to fit snugly; to subsidize; allowance (e.g. money for food or housing); sticker; classifier for sticking plaster: strip;	
馄饨	hún tun: wonton; Taiwan pr. [hun2 dun5];	
豆沙	dòu shā: sweetened bean paste;	
全家福	quán jiā fú: photograph of the entire family; hodgepodge (cookery);	
竹筍	zhú sǔn: bamboo shoot;	
師傅	shī fu: master; qualified worker; respectful form of address for older men; CL:個|个[ge4],位[wei4],名[ming2];	
高麗菜	gāo lí cài: cabbage; CL:顆|颗[ke1],個|个[ge4]; Taiwan pr. [gao1 li4 cai4];	
王	Wáng: surname Wang;  wáng: king or monarch; best or strongest of its type; grand; great;  wàng: to rule; to reign over;	
喜歡	xǐ huan: to like; to be fond of;	
價格	jià gé: price; CL:個|个[ge4];	
濃	nóng: concentrated; dense; strong (smell etc);	
酸豆	suān dòu: tamarind (Tamarindus indica) tropical tree with bean-like fruit; pickled caper;	
擂	léi: beat; to grind;  lèi: to beat (a drum);	
桑拿	sāng ná: sauna (loanword);	
牛肉丸	níu ròu wán: beef meatballs;	
麻辣燙	má là tàng: hot spicy soup (often sold in street stalls);	
圈	juān: to confine; to lock up; to pen in;  juàn: pen (pig); a fold;  quān: circle; ring; loop; classifier for loops, orbits, laps of race etc; CL:個|个[ge4]; to surround; to circle;	
無	wú: not to have; no; none; not; to lack; un-; -less;	
大會	dà huì: general assembly; general meeting; convention; CL:個|个[ge4],屆|届[jie4];	
啤	pí: beer;	
稀飯	xī fàn: porridge; gruel;	
竹林	zhú lín: bamboo forest;	
軒	Xuān: surname Xuan;  xuān: pavilion with a view; high; tall; high fronted, curtained carriage (old);	
糯米	nuò mǐ: glutinous rice; Oryza sativa var. glutinosa;	
雀巢	Què cháo: Nestlé;	
橘子	jú zi: tangerine; CL:個|个[ge4],瓣[ban4];	
走	zǒu: to walk; to go; to run; to move (of vehicle); to visit; to leave; to go away; to die (euph.); from; through; away (in compound verbs, such as 撤走[che4 zou3]); to change (shape, form, meaning);	
价目	jià mù: (marked) price; tariff (in a restaurant etc);	
单	Shàn: surname Shan;  dān: bill; list; form; single; only; sole; odd number; CL:個|个[ge4];	
桂圆	guì yuán: see 龍眼|龙眼[long2 yan3];	
极品	jí pǐn: best quality;	
乌龙	wū lóng: black dragon; unexpected mistake or mishap; oolong (tea); udon (loanword from Japanese);	
鸳鸯	yuān yāng: (Chinese bird species) mandarin duck (Aix galericulata); affectionate couple; happily married couple;	
选	xuǎn: to choose; to pick; to select; to elect;	
玛	mǎ: agate; cornelian;	
纯	chún: pure; simple; unmixed; genuine;	
华	Huá: abbr. for China;  Huà: Mt Hua 華山|华山 in Shaanxi; surname Hua;  huā: old variant of 花[hua1]; flower;	
热饮	rè yǐn: hot drink;	
凤梨	fèng lí: pineapple;	
园	Yuán: surname Yuan;  yuán: land used for growing plants; site used for public recreation;	
饮	yǐn: old variant of 飲|饮[yin3];  yǐn: to drink;  yìn: to give (animals) water to drink;	
虾皮	xiā pí: small dried shrimp;	
乌鸡	wū jī: black-boned chicken; silky fowl; silkie; Gallus gallus domesticus Brisson;	
墨鱼	mò yú: squid; ink fish; cuttlefish;	
橄榄	gǎn lǎn: Chinese olive; olive;	
回锅	huí guō: to cook again; to rewarm food;	
卤肉	lǔ ròu: stewed meat;	
田鸡	tián jī: frog; the Chinese edible frog (Hoplobatrachus rugulosus);	
将	jiāng: will; shall; to use; to take; to checkmate; just a short while ago; (introduces object of main verb, used in the same way as 把[ba3]);  jiàng: general; commander-in-chief (military); king (chess piece); to command; to lead;  qiāng: to desire; to invite; to request;	
红烧肉	hóng shāo ròu: red braised pork;	
相连	xiāng lián: to link; to join; link; connection;	
营养	yíng yǎng: nutrition; nourishment; CL:種|种[zhong3];	
冷面	lěng miàn: grim; stern; harsh;  lěng miàn: naengmyeon (Korean dish based on cold noodles in soup);	
大饼	dà bǐng: large flat bread;	
搅和	jiǎo huo: to mix (up); to blend; to spoil;	
山药	shān yao: Dioscorea opposita; yam;	
火烧	huǒ shāo: to set fire to; to burn down; burning hot; baked cake;	
黄花鱼	huáng huā yú: yellow croaker (fish); corvina;	
烙饼	lào bǐng: pancake; flat bread; griddle cake;	
万	Mò: see 万俟[Mo4 qi2];  Wàn: surname Wan;  wàn: ten thousand; a great number;	
兴	Xīng: surname Xing;  xīng: to rise; to flourish; to become popular; to start; to encourage; to get up; (often used in the negative) to permit or allow (dialect); maybe (dialect);  xìng: feeling or desire to do sth; interest in sth; excitement;	
特价	tè jià: special price;	
酱油	jiàng yóu: soy sauce;	
饮品	yǐn pǐn: beverage;	
凉面	liáng miàn: cold noodles;	
蚂蚁	mǎ yǐ: ant;	
树	shù: tree; CL:棵[ke1]; to cultivate; to set up;	
绍	Shào: surname Shao;  shào: to continue; to carry on;	
开	kāi: to open; to start; to turn on; to boil; to write out (a prescription, check, invoice etc); to operate (vehicle); abbr. for 開爾文|开尔文 degrees Kelvin;	
圆	yuán: circle; round; circular; spherical; (of the moon) full; unit of Chinese currency (Yuan); tactful; to justify;	
清炖	qīng dùn: to stew meat without seasoning;	
糖醋鱼	táng cù yú: sweet and sour fish;	
炖肉	dùn ròu: stewed meat; beef stew;	
两样	liǎng yàng: two kinds; difference;	
饺	jiǎo: dumplings with meat filling;	
速冻	sù dòng: to quick-freeze;	
钖	yáng: ornaments on headstall of horse;	
纸	zhǐ: variant of 紙|纸[zhi3];  zhǐ: paper; CL:張|张[zhang1],沓[da2]; classifier for documents, letter etc;	
汉口	Hàn kǒu: Hankou, part of Wuhan 武漢|武汉 at the junction of Han river and Changjiang in Hubei;	
火红	huǒ hóng: fiery; blazing;	
东坡	Dōng pō: Dongpo District of Meishan City 眉山市[Mei2 shan1 Shi4], Sichuan;	
厨师	chú shī: cook; chef;	
面点	miàn diǎn: pastry;	
莲	lián: lotus;	
块	kuài: lump (of earth); chunk; piece; classifier for pieces of cloth, cake, soap etc; (coll.) classifier for money and currency units;	
计	Jì: surname Ji;  jì: to calculate; to compute; to count; to regard as important; to plan; ruse; meter; gauge;	
发面	fā miàn: to leaven dough; to make bread;	
盐水	Yán shuǐ: Yanshui town in Tainan county 台南縣|台南县[Tai2 nan2 xian4], Taiwan;	
炉火	lú huǒ: the fire of a stove;	
湿	shī: variant of 濕|湿[shi1];  shī: moist; wet;	
斋	zhāi: old variant of 齋|斋[zhai1];  zhāi: to fast or abstain from meat, wine etc; vegetarian diet; study room; building; to give alms (to a monk);	
线	xiàn: variant of 線|线[xian4];  xiàn: thread; string; wire; line; CL:條|条[tiao2],股[gu3],根[gen1];	
马拉	Mǎ lā: Marat (name); Jean-Paul Marat (1743-1793), Swiss scientist and physician;	
盏	zhǎn: a small cup; classifier for lamps;	
咸菜	xián cài: salted vegetables; pickles;	
东江	Dōng jiāng: Dongjiang River;	
时价	shí jià: current price;	
烹饪	pēng rèn: cooking; culinary arts;	
锦绣	jǐn xìu: beautiful;	
拼盘	pīn pán: sampler platter; appetizer platter;	
胶	jiāo: to glue; glue; gum; rubber;	
饭类	fàn lèi: rice dishes (on menu);	
焗饭	jú fàn: rice au gratin;	
餐点	cān diǎn: food; dish; meal;	
凤	Fèng: surname Feng;  fèng: phoenix;	
饸饹	hé le: noodles either made of buckwheat or sorghum;	
天鹅	tiān é: swan;	
毛笔	máo bǐ: writing brush; CL:枝[zhi1],管[guan3];	
开口	kāi kǒu: to open one&#x27;s mouth; to start to talk;	
热茶	rè chá: hot tea;	
带	dài: band; belt; girdle; ribbon; tire; area; zone; region; CL:條|条[tiao2]; to wear; to carry; to take along; to bear (i.e. to have); to lead; to bring; to look after; to raise;	
醉鸡	zuì jī: chicken in rice wine; also translated drunken chicken;	
竹笋	zhú sǔn: bamboo shoot;	
师傅	shī fu: master; qualified worker; respectful form of address for older men; CL:個|个[ge4],位[wei4],名[ming2];	
高丽菜	gāo lí cài: cabbage; CL:顆|颗[ke1],個|个[ge4]; Taiwan pr. [gao1 li4 cai4];	
喜欢	xǐ huan: to like; to be fond of;	
价格	jià gé: price; CL:個|个[ge4];	
浓	nóng: concentrated; dense; strong (smell etc);	
麻辣烫	má là tàng: hot spicy soup (often sold in street stalls);	
稀饭	xī fàn: porridge; gruel;	
轩	xuān: pavilion with a view; high; tall; high fronted, curtained carriage (old);	
福建	Fú jiàn: Fujian province (Fukien) in east China, abbr. 福 or 閩|闽, capital Fuzhou 福州;	
鐵板燒	tiě bǎn shāo: teppanyaki;	
碟	dié: dish; plate;	
脷	lì: (cattle) tongue (Cantonese);	
西式	xī shì: Western style;	
超級	chāo jí: super-; ultra-; hyper-;	
最佳	zuì jiā: optimum; optimal; peak; best (athlete, movie etc);	
焗烤	jú kǎo: to bake; gratin;	
人氣	rén qì: popularity; personality; character;	
肉醬	ròu jiàng: mincemeat; pâté;	
檸檬茶	níng méng chá: lemon tea;	
蘆薈	lú huì: aloe vera;	
生薑	shēng jiāng: fresh ginger;	
混	hún: confused; dirty; to mix; muddy; variant of 渾|浑[hun2];  hùn: to mix; to mingle; muddled; to drift along; to muddle along; to pass for; to get along with sb; thoughtless; reckless;	
明火	míng huǒ: flame; open fire;	
螺旋藻	luó xuán zǎo: spiral algae; spirulina (dietary supplement);	
下酒菜	xià jǐu cài: a dish that goes well with alcoholic drinks;	
九孔	jǐu kǒng: abalone (Haliotis diversicolor);	
羅馬	Luó mǎ: Rome, capital of Italy;	
雪蓮	xuě lián: snow lotus herb; Saussurea involucrata;	
粽	zòng: rice dumplings wrapped in leaves;  zòng: variant of 粽[zong4];	
大棗	dà zǎo: see 紅棗|红枣[hong2 zao3] (red jujube, red date)	
棗	zǎo: jujube; dates;	
包菜	bāo cài: cabbage;	
陳醋	chén cù: mature vinegar;	
風	fēng: wind; news; style; custom; manner; CL:陣|阵[zhen4],絲|丝[si1];	
自	zì: from; self; oneself; since;	
杏	xìng: apricot; almond;	
魚排	yú pái: fish steak;	
花枝	[hua1 zhi1] (lit. flowering branch) cuttlefish or squid	
雪花	[xue3 hua1] snowflake, often used in&nbsp;雪花酥 [xue3 hua1 su1], a type of dessert	
蛤蜊	[ge2 li2] clam	
台灣	[tai2 wan1] Taiwan (trad.)	
火鍋	[huo3 guo1] hot pot (trad.)	
台湾	[tai2 wan1] Taiwan (simp.)	
火锅	[huo3 guo1] hot pot (simp.)	